云中塔芋螺是一种新腹足目、芋螺科类生物，螺壳尺寸33.1mm。分布于巴拿马西部。	生物	生物
《反西游记之混混唐僧》是吴老狼在小说网上连载的一本小说。	小说	小说
《中国往事》是由张黎执导，张国立、朱茵、赵立新、朱雨辰等主演的人文古装电视剧。该剧讲述了清朝末年，南方苍河桑镇大户郑家和榆镇大户曹家之间的恩怨情仇，悲欢离合。该剧于2009年1月1日在东方卫视、浙江卫视、河北卫视、山东卫视上星首轮播出。	电视剧	电视剧
《那点焰火藏植在幽闭岁月里》是连载于起点中文网的小说，作者是桐柏。	小说	小说
圣地海滩度假酒店位于黄金海岸，是家4星级酒店。是黄金海岸不可错过的酒店之一。在这里，您将深深体会到宾至如归的愉悦与惬意。酒店位置较好，距离黄金海岸机场打车6分钟，车程约5.0公里。	酒店	酒店
《手表密码》是小说阅读网所连载的一部推理悬疑类网络小说。作者是白~羊~梦。	小说	小说
在线影评人协会（英语：OnlineFilmCriticsSociety）是互联网上的一家专业影评人协会，它建立于1997年。	协会	协会
龙翔网为成都艾美控网络科技有限公司旗下网站，创建于2006年，是一家专注于网购省钱的国内领先的电商导购平台。龙翔网为消费者提供网购优惠券、购物返利、折扣推荐等一站式省钱服务，已与淘宝网、当当、唯品会等800多家网购商城建立了合作，在为数百万消费者服务的同时，每月为合作商家带去上百万销售额。	公司,网站	网站,公司
藏獒博览网是一家起点高，服务好，发展快的专业藏獒媒体网站；是中国藏獒界最具权威性与影响力的专业性网站；信息量大、覆盖面广、功能强、知名度高的网站;具有权威性、全面性、专业性等特点并且有大型书刊《藏獒博览》。藏獒博览网(英文名：zablw)是中国藏獒产业专业的传媒机构，全国藏獒爱好者浏览和交易藏獒的平台。藏獒博览网作为藏獒行业的一家大型藏獒网站，始终秉承以优质的服务，和精益求精的精神为全国獒友服务。	网站,专业藏獒媒体网站	网站
《错许一生》是作者尽尘雪在起点中文网连载的小说	小说	
《半面状》是连载于起点中文网的小说，作者是蓝调无伤。	小说	小说
李树奎，1964年10月出生，毕业于北京理工大学，现任北京理工大学教授，博士生导师。	教授	教授
辽宁华冶集团发展有限公司位于中国的钢都-鞍山，属重工电气装备制造型企业。华冶集团拥有“省级企业技术中心”和“中国驰名商标”的荣誉称号，是“辽宁省高新技术企业”和“省腾龙计划重点发展企业”、“鞍山重点发展十户企业”之一。	公司	公司
普臣科技实业有限公司位于珠江三角洲腹地，闻名于海外的“家电之乡”——顺德，是一家专业致力于家用、商用净水设备研究与开发、制造销售的科技型企业，是国内净水行业最具开发能力、最具规模，产品最具竞争力的企业之一。	公司	公司
黑魔法（英文：blackmagic、日文：黒魔术【くろまじゅつ】）又称为黑巫术。即邪恶的魔法，最早是由日本电子游戏创造的术法概念。主要以伤害别人为目的，透过放蛊、咒诅、秘密仪式、书符等方式，达到谋杀、致病、迷惑、役使、嫁祸等目的，使人在不知不觉受害。多用于对付仇敌或报复他人，亦可用作治病、驱邪，或针对他人所施行的魔法进行治疗、防御或反击。亦有人指黑魔法是魔鬼的辖区，借助于一大群邪灵或恶魔的帮助，魔鬼得以进行他邪恶的工作；而帮助魔鬼的人，则得以施展黑魔法的能力。与黑魔法相对的概念是白魔法。	概念	游戏
黄冈职业技术学院（HuanggangPolytechnicCollege）位于湖北省黄冈市，是一所经国家教育部批准组建的公办全日制普通高等职业院校，为“国家示范性高等职业院校建设计划”骨干高职院校立项建设单位，国家首批现代学徒制试点单位，是教育部高职高专人才培养工作水平评估优秀院校。黄冈职业技术学院的办学历史最早可追溯至创建于1949年的黄冈专区财经干部班，1999年，黄冈财贸学校、黄冈机电学校、黄冈农业学校合并组建并升格为黄冈职业技术学院。截至2015年6月，学校占地面积1200余亩，建筑面积45万平方米；有专任教师798人，设有二级教学学院8个，开办58个专科专业，全日制在校生2万余人。	学校	学校
《穿越成流氓》是晋江文学城连载的爱情类小说，小说作者是太文艺啊。	小说	小说
田培良，实力派音乐创作人，原创歌手。	音乐创作人	歌手
《夜色微凉之不做替身情人》是颜家小妖在潇湘书院连载的网络小说。	小说	小说
《机器人跳跳》是一款简单而又容易让人上瘾的小游戏，游戏画面简洁，操作简单。	游戏,小游戏	游戏
弗格齐乐队成立于1987年，成员有：鼓手布莱登·坎迪（BrendanCanty）、贝司手乔·莱利（JoeLally）、吉他手兼主唱伊恩·麦克凯耶（IanMacKaye）、盖伊·庇西奥托（GuyPicciotto）。其实早在组建之前，乐队成员在华盛顿崩克音乐圈里已经享有了很高的声望。麦克凯耶当时是Dischord唱片公司的一哥，刚刚离开作为“情绪核”（Emocore）音乐创始人的“拥抱（Embrace）”乐队。	乐队	公司
意大利忠利保险有限公司（ASSICURAZIONIGENERALI）成立于1831年，迄今已有170多年的保险经营经验。忠利集团作为世界最大保险集团之一，其旗下的100多家保险及金融实体遍布全球50多个国家。目前，忠利集团在全球拥有58,000多名雇员，是一家真正拥有国际化网络的跨国集团。2004年忠利集团合并保费收入达563亿欧元，同比增长13.6%。	公司	公司
绢毛风毛菊（学名：Saussureapubescens）为菊科风毛菊属的植物，为中国的特有植物。分布于中国大陆的西藏等地，生长于海拔5,150米的地区，见于山坡，目前尚未由人工引种栽培。	植物	植物
科拉莉，电影演员、导演、编制等，代表电影有《Sombre》、《操我》等。	导演,编制,电影演员	电影演员
《圣战时代》的第3部是一款策略防御游戏，相比前两部，第三部增加了更多的元素和玩法。	游戏	游戏
《异世界之大逃亡》是连载于小说吧的穿越架空小说，作者是筮血的夜。	小说	小说
典雅精品酒店位于第比利斯，是家4星级酒店。	酒店	酒店
《花开花落之不离不散》是一部小说，作者是向锋，连载网站起点中文网。	小说	小说
《醉桃源禄存文曲》是一首诗歌，作者是元代著名诗人王吉昌，正文有禄存文曲附神光。驱驱逐色忙。昧禅徒乱角和商。	诗歌	诗歌
《仲夏夜之梦》，门德尔松为莎士比亚的喜剧《仲夏夜之梦》共写过两部音乐作品，一部是在1826年作者十七岁那年所作的钢琴四手联弹《仲夏夜之梦》序曲，次年改编成管弦乐曲，被称为是音乐史上第一部浪漫主义标题性音乐会序曲；另一部是1843年为《仲夏夜之梦》所写的戏剧配乐，其中的序曲就选用了当年所作的序曲。	戏剧	
《中国标准化》创刊于1958年，由国家质检总局主管，中国标准化研究院和中国标准化协会共同主办的标准行业权威学术期刊。	期刊	期刊
布莱恩·安古洛是一名哥伦比亚足球运动员。	运动员,足球运动员,哥伦比亚足球运动员	足球运动员
《穿越之邪王猎妃》是连载于3G书城的综合小说，作者是羽悠。	小说	小说
《西方六国政府学校关系变革》是一本冯大鸣编制，由上海教育出版社在2011-05-01出版的书籍。《西方六国政府学校关系变革》对美国、英国、德国、法国、澳大利亚、日本等西方六国20年来的政府-学校关系变革以及教育行政架构进行梳理与研究，分析和归纳西方六国政府-学校关系变革所取得的成效，总结其中八条正反经验，可为我国当前的教育管理体制改革提供借鉴。	书籍	学校,书籍
《雾之奏》是晋江文学城连载的架空历史小说，作者是洛桑。	小说	小说
《出逃的爱情》是由呓语如风所著的一本言情小说，作品状态：连载中。	小说	小说
《千尘天下》是作家夏卿然创作的一本原创小说，连载于晋江文学城，尚未完结。	小说	小说
深远集团公司成立于1993年，始终坚持"以人为本，以市场为核心"的原则，不断引进和培养高素质的专业人才，不断借鉴国内外成功的经营管理经验，并且积极吸收和引进国内外领先技术和高新产品。现已发展成为集科、工、贸于一体的食品、保健品、医药制品等原辅料供应的综合性企业集团。并已成功通过ISO9001:2000国际质量体系认证。	公司	公司
南昌亚洲啤酒有限公司是由菲律宾著名爱国华侨领陈永栽先生投资控股的中外合资企业（现已被百威英博收购）。具有20万吨生产能力和设备先进的江西最大啤酒制造企业和省、市重点企业。	公司,酒	公司
柏那卡精品酒店位于槟城，是家4星级酒店。酒店位置较好，距离槟城小印度步行15分钟。	酒店	酒店
《学校1.0自由时代》是在红袖添香网上连载的一部小说，作者是532705665。	小说	小说
《海的距离有多远》是一本连载在晋江文学城的小说，作者是依家。	小说	小说
凶案组的组长艾尔正准备出来竞选市长，但一站出来发表政治演说便遭到枪杀。凶案组的成员在震惊之馀，决定联手合力侦查这宗可能是他们迄今以来最辣手的案件。本片与其说是一部独立成篇的警察电影，不如说是电视警察影集「法理情的春天」系列的完结篇。在原来影集中没有获得解答的问题，在各季影集中出现过的一些重要角色，在本片中统统有了交代。对於这个影集的忠实影迷而言，固然会乐不可支，但新观众可能会对某些情节发展根不上。剧情描述凶案组的组长艾尔正准备出来竞选市长，但一站出来发表政治演说便遭到枪杀。凶案组的成员在震惊之馀，决定联手合力侦查这宗可能是他们迄今以来最辣手的案件。本片的剧本写得相当出色，对于艾尔的父子亲情尤其有动人的刻画。约菲柯图、丹尼尔鲍德温、尼特比提等都演得出色。	电影	电影
《七签》是连载于起点中文网的小说，作者是书剑。	小说	小说
《我的下半生给了谁》是连载在起点中文网的一本小说，作者是陌荒阡。	小说	小说
济南市章丘区第三职业中等专业学校简称章丘三职专，创建于1968年，是国家级重点职业中专，山东省济南市素质教育实践基地。40多年来，学校坚持以服务为宗旨，以就业为导向，以“为学生创造主动发展的无限空间”为教育理念，推行了“办学形式多元化，教学管理民主化，理论学习层次化，技能培养目标化，专业实习企业化，学生考核社会化”等多项教育教学改革，取得了突出的办学成绩。2015年9月6日，章丘三职专与济南市章丘区教师进修学校、济南市素质教育实践基地等一起顺利迁入章丘职成教中心。	学校	学校
时代广场服务式公寓位于槟城，是家3星级酒店。时代广场服务式公寓让您在槟城这个陌生又熟悉的城市，感受到一丝清浅但又实在的温暖。您一定不能错过。酒店位置较好，距离槟城小印度打车6分钟，车程约2.9公里。	酒店	酒店
《薰衣草等待的那个初夏》是海夜蓝羽写的网络小说连载于17k小说网。	小说	小说
《男佣王爷：我的王爷不一般》是云中书城连载的小说，作者是日月秋水。	小说	小说
《一粒沙子》是起点中文网连载的一部小说，作者是珍珠也疯狂。	小说	小说
FortunaHotelBukitBintang位于吉隆坡，是家2星级酒店。吉隆坡理想的下榻之处，您的旅途也将因此而与一份温暖、一份感动不期而遇。酒店位置较好，距离吉隆坡双子塔步行22分钟，或打车6分钟，车程约2.2公里。	酒店	酒店
2008年第15号超强台风。	台风,超强台风	
《矮平房的故事》是连载于起点中文网的都市言情小说，作者是满小鱼。	小说	小说
《职业性动作》是连载于起点中文网的一部都市小说，作者是李万虎雨枫。	小说	小说
《能量装甲》是一款综合小游戏，游戏大小为7270K。	游戏	游戏
深圳香村生物科技有限公司，终于在沉淀了近十年的台湾传统精油护肤理念，终于在2012年成立了，源自台湾，潜心于天然精油个人护理产品的研发，生产，销售及进出口	公司	公司
里维埃拉酒店位于普吉岛，是家3星级酒店。酒店，距离普吉西蒙人妖秀打车9分钟，车程约5.9公里。	酒店	酒店
南安市九都中学创办于1971年，是一所泉州市达标初中校。学校坐落于镇区新东村内，占地面积23001平方米，依山傍水，环境优雅，空气清新，景色宜人，是学生汲取知识、提高素质、陶冶情操的理想场所。	学校	学校
田淑媛,写作,高级教师。省、市、区教学能手,省模范教师，省优秀班主,省骨干教师。全国手拉手作文大赛园丁奖。太原市十佳百优教师,市导师团导师。	教师	市导师团导师,高级教师,教师
《玉人吹箫击剑舞》是飞库网进行连载的小说，作者是米勒大叔。	小说	小说
黄仁植，韩国人，演员。合气道七段、跆拳道六段高手，代表作有《合气道》、《跆拳震九州》、《师弟出马》、《龙少爷》、《虎鹰》等。擅长腿技、擒拿和摔投，特点是动作迅捷，招式老到，被称为左腿攻击之王。	演员	演员
郑健，男，潍坊晚报非著名记者。	记者,著名记者,潍坊晚报非著名记者	
张大牛，网络小说作家，浙江杭州人。	小说,网络小说作家	小说作家
中国人民解放军总参通直职业技术学校隶属于中国人民解放军总参通信部，是一所省部级重点职业学校。学校始建于1971年，其前身为”7.21”工人大学。学校位于重庆市北碚区，校园占地面积200余亩，校舍建筑面积20000多平方米，可容纳学生1500名	学校	学校
宁夏源宝生物有限公司致力于建立健康和快乐的饮食方式，向全世界分享来自大自然的力量。	公司	公司
《幻雪江湖》是一本由网络作家郁？�所写的武侠小说，该作品目前已经完成。	小说	小说
《四像天轮》是在起点中文网上连载的一部小说，作者是末钰。	小说	小说
黄家湾自然村隶属于云南省昭通大关县吉利镇鱼田行政村，属于山区。东与盐津县相接，南与青海自然村相接，西与响水沟自然村相接，北与木杆镇相接。国土面积有6.41平方公里，海拔1175米，年平均气温16℃，年降水量900毫米，适宜种植玉米等农作物。有耕地1446亩，其中人均耕地2亩；有林地6750亩。全村辖4个村民小组，有农户207户，有乡村人口676人（含居民），其中农业人口676人，劳动力393人，其中从事第一产业人数265人。2006年全村经济总收入96.3万元，农民人均纯收入985元。该村属于贫困村，农民收入主要以种养业为主。	自然村	村
《华穿：霸王萧宠妃》是小妮箫猫写的网络小说连载于红袖添香网。	小说	小说
马库斯·弗拉塞尔，男，是一名足球运动员，场上位置是后卫。	运动员	足球运动员
高升铺散马先蒿（学名：PedicularisdiffusaPrainsubsp.elatiorTsoong）是一种马先蒿属植物。	植物	植物
《弑杀神魔曲》是由虾米XL所作的玄幻魔法类小说。	小说	小说
明戈齐是一名足球运动员，生日是1984-12-29,场上位置是中前卫，惯用脚是右脚。2008年7月15日，打算去特雷维索俱乐部参加俱乐部在奥地利夏训前的例行体检的明戈齐独自一人驾驶保时捷跑车行驶在距离威尼斯不远的卢皮亚乡村小镇的街道上，与迎面而来的一辆卡车相撞，明戈齐当场身亡。	运动员,足球运动员	足球运动员
秘恋厚爱是一部都市言情小说，作者樱歌，在17k小说网网站连载。	小说	小说
《江心一叶舟》是连载在晋江文学城的小说，作者是贺松年。	小说	小说
AS狭山足球俱乐部，英文名SayamaFCWomen\'s，国语译名AS狭山	俱乐部,足球俱乐部	
《爱情爱隐身》是一部连载于晋江文学城的爱情小说，作者是木难情。	小说	小说
肥东县店埠镇亲亲幼儿园位於安徽省合肥市肥东县店埠镇浮槎路包公路，园长：黄茹。	幼儿园	
陈道东，男，汉族，1962年10月出生，四川彭州人，中共党员，中国林科院森林土壤专业在职研究生学历，硕士学位，研究员。现任国家林业局党校常务副校长、国家林业局管理干部学院副院长（正司局级）。	研究员	研究员
《朕的杀手狂妃往哪跑！》是一部连载于红袖添香网的言情类小说。	小说	小说
《美人三笑摄天下》是在3G书城连载的小说，作者是还太早。	小说	小说
秦磊，现任北京市平谷区金融工作办公室主任。	主任	作办公室主任
《绝妙拍档》是一部连载于好123小说的言情小说，已完结，作者是红菱_hx3。	小说	小说
《老爸爱赌博》是连载于起点中文网的乡村乡土小说，作者是草木燎原。	小说	小说
《消化科急危重症》是军事医学科学出版社2011年出版的书籍。共包括二十五章内容，每个疾病都分为四部分。第一部分为疾病概述。简洁、明了介绍疾病的定义。第二部分为救治流程。	书籍	书籍
耿莉萍：女，1959年生，北京工商大学教授。	教授,北京工商大学教授	北京工商大学教授
周琦,女,汉族,1974年12月生，黑龙江省齐齐哈尔市人，1996年5月加入中国共产党，1996年7月参加工作，哈尔滨师范大学历史专业，硕士研究生。现任省统计局普查中心副调研员、龙沙区政府副区长（挂职锻炼）。	副调研员,省统计局普查中心副调研员,龙沙区政府副区长	副调研员
广金钱草，中药名。为豆科植物广金钱草DesmodiumstyracifoLium,(Osb.)Merr.的干燥地上部分。夏、秋二季采割，除去杂质，晒干	植物	植物
《谁证痴情》是一部小说，作者是笑狐。	小说	小说
《梦向何方》是连载于起点中文网的小说，作者是我若无情。	小说	小说
《最后的空气》是17k小说网连载的小说，作者是微琪。	小说	小说
《空墙》是晋江文学城连载的同人其它小说，作者是浅纳。	小说	小说
敦煌研究院的前身是1944年成立的国立敦煌艺术研究所，1950年改组为敦煌文物研究所，1984年扩建为敦煌研究院。敦煌研究院是敦煌学研究的科研单位。也是保护敦煌石窟（莫高窟、榆林窟、西千佛洞）和麦积山石窟、炳灵寺石窟、北石窟寺等其它文物机构的文博单位；是爱国主义教育基地，也是旅游接待单位。常书鸿促成了国立敦煌艺术研究所的成立，他视莫高窟为“家”，被誉为“敦煌守护神”，这5个字就镌刻在常书鸿先生的墓碑上。2017年5月，在庆祝“国际博物馆日”之际，国家一级博物馆授牌仪式近日在北京举行，敦煌研究院成功晋级，成为国家文物局第三批新增的34家国家一级博物馆的其中之一。	研究院	
《穿越之过眼云烟》是红袖添香网连载的小说，作者是沁吣。	小说	小说
于代君，男，大陆演员，曾参演多部电影，电视剧。	演员	演员,电影,电视剧
黔城，现洪江市市治黔城，旧黔阳县县治所在地，有两千多年的历史。位于沅水上游的省级历史文化名城——新市治黔城是全国保存最为完好的明清古城之一，古城三面环水，是湘楚苗地边陲重镇，素有“滇黔门户”和“湘西第一古镇”之称。古城历史城区总面积0.8平方公里，城内青石街巷纵横交错，明清建筑比比皆是。原有五个城门今尚存四门遗址，依附南北两条主要街道而形成的鱼骨状道路系统保存完整，古称九街十八巷，黔阳古城以明清建筑为主调，并有机融合了本地侗族、苗族建筑特色，古民居敞亮明净，古宫祠华丽精致，建筑风格极具特色。	历史	遗址
诡面少爷1是幻剑书盟连载的网络小说，作者是异世猫妖	小说	小说
梅斯国立工程师学校是一所国家公立大学，它坐落在梅斯的索罗西岛上，成立于1961年，属于由（布雷斯特、梅斯、圣艾蒂安、达尔伯）四所学校组成的“国立工程师学院（ENI）”集团成员·学校教授高等理论与实践课程，以培养全科型工程师，它招收从高中毕业到本科毕业的工程师专业的学生。	学校,国家公立大学	学校教授,学校,工程师
《青荷梦断月华生》是一本连载于云中书城的都市言情小说，作者是沐沐宜修。	小说	小说
孔云鹏，当代武术家，弘扬祖国原生态太极文化，揭示中华内家拳养生真谛。由中国武当派著孔云鹏老师一生走南闯北，传奇颇多，嵊州电视台、今日嵊州几次专题介绍报道过他的一些传奇经历。现孔云鹏老师已年过不惑，早褪去了当年的少年轻狂，多年的习武生涯，再加上孔云鹏老师亦文亦武，研读了许多的武术、经络、养生等等的书籍，他深觉武术对性情陶冶以及文化传承有很大的作用，太极拳则是最好的载体。他有了一个新愿望，就是在家乡把太极拳发扬光大，让更多的人了解太极拳，了解中国武术，让更多的人练武强身。2007年8月，孔云鹏老师结束仗剑走天涯的江湖走侠生活回到嵊州，名武术家孔云鹏老师亲自执教。	武术家	书籍
大岭山镇，隶属于广东省东莞市，位于东莞市中南部，南部分别与深圳市的罗田村和东莞市的长安镇接址，西南与虎门镇相连，西至西北分别与厚街镇、南城区（篁村）、东城区（附城）相接，北到东北与寮步镇相连，东至东南与大朗镇相邻。截至2013年，大岭山镇面积110平方公里（包含松山湖高新科技产业园征地部分），辖21个村和2个社区。户籍人口4.65万人，常住人口28.21万人。大岭山镇曾被评为中国家具出口第一镇、中国家具出口重镇，也是国家卫生镇、全国环境优美乡镇、国家级生态乡镇。2018年10月，入选“2018年度全国综合实力千强镇前100名”。	乡镇	乡镇,社区
薰变，连载网站晋江文学城，作者是cherryoo，小说类型近代现代。	小说	小说
陈传夫，男，1962年生，汉族。图书馆法与知识产权委员会副主任委员。1962年生。武汉大学图书馆学硕士，法学博士。武汉大学信息管理学院教授，武汉大学本科生院院长，曾任武汉大学信息管理学院院长，武汉大学教务部部长。知识管理与知识产权方向博士研究生导师，武汉大学信息资源研究中心教授，武汉大学国际法研究所兼职教授。应邀以高级访问学者身份赴美国美国华盛顿大学、法国巴黎十一大学法学院、英国东安哥利亚大学法学院从事研究工作。主持完成国家自然科学基金、国家社会科学基金、欧盟中国高等教育合作知识产权项目5项。	教授	副主任委员,教授
《侠骨仗剑行》是开山启剑写的传统武侠小说，连载网站是幻剑书盟。	小说	小说
逃出青蛙房间是一款网页上的益智小游戏。	游戏	游戏
《死亡迷雾》是在红袖添香网上连载的一部推理悬疑小说，作者是妖之九尾。	小说	小说
徐露，硕士学历，成都师范学院教师，研究方向为景观艺术设计研究。[1]	教师	教师
《都市神龙传说》是连载在起点中文网的小说，作者是叶家小十三。	小说	小说
贝耶尔里奇霍夫酒店位于罗滕堡，是家2星级酒店。贝耶尔里奇霍夫酒店让您在罗滕堡这个陌生又熟悉的城市，感受到一丝清浅但又实在的温暖。您一定不能错过。酒店，距离罗滕堡城墙步行6分钟。	酒店	酒店
《与猪奋斗在异界》是一部连载于起点中文网的异世争霸类小说，作者是迷途猪。	小说	小说
《中国外语教育品牌战略研究》是2012-5出版的教育类书籍，作者李雪岩。	书籍	书籍
涪陵区罗云乡党委委员、政法书记	政法书记,涪陵区罗云乡党委委员	
哈尔滨云马酒店连锁（勃莱梅站前旅馆）是一家标准商务型酒店，位于哈尔滨站右侧，毗邻南岗繁华商业区，距果戈里大街步行10分钟，距秋林公司步行15分钟。	旅馆	酒店,公司
自强计划是由清华大学主导的自主选拔计划，清华大学、南京大学、上海交通大学、西安交通大学、浙江大学、中国科学技术大学等6所知名高校将共同实施针对全国农村学生的自主选拔“新百年自强计划”，为寒门学子创造更多进入名校的机会。2014年的“自强计划”从以往只能报一所学校，改为可6选3，并首次将全国乡镇农村中学纳入招生计划。	自主选拔计划	学校
近年来，中国联通临夏回族自治州分公司坚持以科学发展观为指导，全面贯彻甘肃省分公司战略思路，充分发挥自身优势，着力推动企业持续健康快速发展。公司始终坚持以市场为导向，以客户为中心，持续改善品牌形象，通信能力、业务规模和整体实力不断得到提升，网络建设、市场拓展、业务服务、经营管理、队伍建设等各方面工作取得了长足进步。	公司	公司
《学做水果拼盘》是一本面向大众的厨艺教学类书籍，出版社是黑龙江文化音像出版社。	书籍,厨艺教学类书籍	书籍
中华慈善奖是由国家民政部颁发的我国政府最高规格的慈善奖项，于2005年（乙酉年）设立。“中华慈善奖”在原来的“爱心捐助奖”基础上更名设立，每年评选一次，按爱心捐赠、志愿服务、慈善项目三类分别评选，表彰在赈灾、扶老、助残、救孤、济困、助学、助医以及支持文化艺术、环境保护等方面的作出突出贡献的个人、机构，以及优秀慈善项目。2014年7月25日，民政部举行首个例行新闻发布会。公布了中华慈善奖评选方法的改革。2018年9月13日，第十届“中华慈善奖”在北京人民大会堂举行表彰大会，共表彰慈善楷模28名、慈善项目49个、捐赠企业37个、捐赠个人16名。	奖项	
《吸烟的女孩》是连载于晋江文学城的小说，作者是陌下花落。	小说	小说
北京汉青天朗水处理科技有限公司（BeijingEcojoyWaterTechnologyCo.,Ltd.）创立于2002年5月，原名“北京汇佳汉青中水科技有限公司”，是中关村科技园区内的高新技术企业、中国环保产业协会第四届理事会理事单位、中华全国工商业联合会环境服务业商会单位会员	公司	公司
昆明“和萃堂”公司于2012年7月诞生于中国西南地区的核心城市——昆明，位于有昆明CBD之称的金马坊商圈，注册资本500万元。公司致力于将“和萃堂”打造成国内顶尖的文化品牌，现已完成阶段性的产业化布局，是符合振兴中国西南地区文化产业发展的文化产业企业。	公司	公司
洁白长臂虾是一类长臂虾科、长臂虾的水生动物。	动物	动物
防空坦克是一款坦克，游戏大小为3.8MB。	游戏	游戏
陶瓷制造工序之一。将配料做成规定尺寸和形状，并具有一定机械强度的生坯。有干压成型、半干压成型、可塑成型、注浆成型法等、等静压法。其中等静压法为新兴陶瓷生产工艺。该方法生产的陶瓷工件经烧结成型后，具有强度大，密度均匀，良好的可加工性。古代陶器有模制、泥条盘筑、捏塑法等。	工艺	
埃菲尔山脉地质公园，位于中欧中部。显示出地形平缓的丘陵景观，V字形山谷切入古老的泥盆纪沉积物。	公园	公园
中井和哉，1967年11月25日出生于日本兵库县神户市，日本男配音演员（声优），隶属于青二Production事务所。擅长出演帅气冷酷又有点搞笑的角色，代表作有《海贼王》罗罗诺亚·索隆、《银魂》土方十四郎、《圣斗士星矢冥王神话》艾尔熙德、《xxxHOLiC》百目鬼静、《微笑的闪士》虎岛弥次郎、《混沌武士》无幻、《战国BASARA》伊达政宗、《真·三国无双》夏侯惇、典韦《血界战线》扎普·伦弗洛等。	声优	演员
《SetMeFreeII》是由刘慕尧作词，黄义达作曲，黄义达演唱的一首歌曲，收录在专辑《写给自己的歌》中。这是一首流行风格的歌曲，歌曲展现了黄义达的高超唱功及创作功力。	歌曲	歌曲
《我是杨小邪》是连载于起点中文网的玄幻小说小说，作者是流氓小侠。	小说	小说小说
朱之琳，女，籍贯，江苏吴江。福州屏东中学校长。福建省中学特级教师。福州市语文学会会长。	福州屏东中学校长	教师,学校长
洛桑念扎，1986年8月16日出生于西藏自治区拉萨市，中国内地男演员、歌手，毕业于上海戏剧学院表演系。2010年，参演电影《天脊》，饰演岗热而正式出道。2012年，在历史题材电视剧《西藏秘密》中，饰演进步青年汪丹。2013年，在抗日剧《决战桂林》，饰演周启明。2014年，由其主演的电影《德吉的诉讼》获2013年德国科隆电影节中国最佳影片奖和第八届法国巴黎中国电影节优秀编剧奖。	演员,歌手	演员,歌手
DuetGame是一款基于抽象风格，搭配音乐元素，拓展发散性思维的休闲类音乐游戏。	游戏,音乐元素	游戏
《刀落龙潭》是就见沙场所著起点中文网连载的玄幻小说。	小说	小说
《秋梦盈轩》是连载于新浪读书的网络小说，作者是wangyunxia38。	小说	小说
高丽参（学名：Panaxginseng）学术名称朝鲜参、别直参（一般特指朝鲜半岛产的红参）。五加科植物人参带根茎的根，经加工蒸制而成。分北朝鲜红参和南朝鲜红参。朝鲜半岛出产的人参依加工工艺又可分为水参、太极参、白参及高丽参（红参）。高丽参有大补元气、生津安神等作用，适用于惊悸失眠者，体虚者，心力衰竭、心源性休克等。现代医学研究显示，高丽参有多种滋补效能。日本和韩国（南朝鲜）学者经研究发现，高丽参在预防糖尿病，动脉硬化，高血压等方面有明显效果，高丽参还有抗癌，控制疾病，促进血液循环，防止疲劳，增强免疫力等方面的功效，其发源地同样也是其最著名的产地为朝鲜半岛南部的忠清南道锦山郡（属南韩方面管辖）。	植物	植物,疾病
浩东，原名陈浩东，南京军旅歌手，1989年12月27日出生于江苏淮安。2014年11月19日发行了EP专辑《好兄弟》收录了三首，分别为；主打歌曲《好兄弟》对兄弟的感情；《离家的人》对家乡的爱与思念；《为爱受罪》对爱的倾诉。	歌手	歌手
辽宁和泉石油装备制造有限公司位于中国重要的石油工业基地－－辽宁省盘锦市，是国家泵行业的专业生产厂之一，也是批准取得全国生产许可证的厂家之一，并且是中石化设备定点企业和能源一号网成员单位，现已通过ISO9001：2000标准质量体系认证。	公司	公司
《恋爱魔法学院》是连载在云中书城的小说，作者是奶小咪。	小说	小说
《LoveisLight》是香港女歌手林欣彤的第二张粤语专辑，原本预定在2012年6月28日推出，后因林欣彤的声带发病，其专辑一度押后至7月13日推出，后来经医生建议待声带全面康复后才工作，令专辑一再押后至8月24日才推出，随碟附送DVD一片。该专辑收录13首歌曲。	粤语专辑	歌曲,专辑
王子站是东日本旅客铁道（JR东日本）、东京地下铁的铁路车站，位于东京都北区王子一丁目。	车站	车站
《暗袖幽》是炮温泉写的网络小说连载于起点中文网。	小说	小说
羌活属（学名：Notopterygium）是伞形科下的一个属，为多年生草本植物。该属共有两种、一变种，为中国特有。	植物	植物
《真神驾到》是一部连载在起点中文网的异界大陆小说，作者是白族小猿。	小说	小说
《御剑残魂》是连载于起点中文网的小说，作者是残忆枫。	小说	小说
《文昭结》是连载于潇湘书院网的小说，作者是卿泺。	小说	小说
《浅唱の森林》是在幻侠小说连载的小说，作者是zhaokeyu1997。	小说	小说
《风流羽神传概述》是一部连载于幻剑书盟的异界大陆小说，作者是冰姬与冻蔷。	小说	小说
碧荷若度假及Spa酒店位于杜马盖地，是家3星级酒店。是杜马盖地最热门的酒店之一。也是您来到杜马盖地商务和休闲的热门之选。酒店。	酒店	酒店
《灰鹰：邪恶元素之神殿》是TroikaGames开发的一款角色扮演游戏。	游戏	游戏
《演艺是个圈》是一部原创长篇小说，主要讲演艺圈的一些故事。	小说	小说
襄阳市第三十九中学（原襄樊市第三十九中学），创建于1968年。原先是一所襄阳棉纺厂子弟学校，现为一所市直公立学校。有三栋教学楼，一个标准操场。该校办学条件良好，学校设有学前班、小学部和初中部。现任校长为孙彤。	学校	学校
《一个家庭的命运》是连载于17k小说网的都市生活小说，作者是祭奠回忆的尘。	小说	小说
维也纳酒店南宁朝阳路店位于火车站附近，邻近万达购物广场、金之岛购物中心、兴宁步行街，是一家由国外名师以欧式、艺术、经典、温馨为设计理念装修的一家精品商务酒店。客房配备新型环保设施的洗浴间、中央可控空调、宽频液晶数字电视、甜之梦床垫、独立保险箱、免费高速上网、国际国内直拨电话、茶具、电热水壶、吹风机等温馨个性化的设施。另有西餐厅、咖啡厅、会议室等配套设施，是进行商务活动、旅游休闲的理想选择。	酒店	酒店
中里站为桦太大泊郡千岁村存在过的铁道省桦太东线之车站。	车站	车站
达米尔·马尔基安(DamirMarijan),斯洛文尼亚籍足球运动员，现效力于佩利根，在场位置为后卫。	足球运动员	足球运动员
郭振海，副研究员，男，1966年8月11日生，1986年毕业于河北师范学院，1992年获兰州大学硕士学位，1997年获北京大学博士学位，1997-1999在北京大学环境科学中心进行博士后研究，1999-2001在日本北海道大学低温科学研究所任客座教授，2001-至今在中国科学院大气物理研究所进行研究工作。主要从事大气边界层湍流扩散、边界层云、海洋边界层和陆面过程等的数值模拟及其资料同化、气候系统模式程序优化、并行计算技术和自动伴随模式开发等研究。	副研究员	教授,副研究员
阿拉·艾哈迈德·卡西姆出生于1996-11-10，是伊拉克的足球运动员。	运动员,足球运动员	足球运动员
上海美嵌智能科技有限公司由博士和行业专家组建而成。专注于短距离无线通信领域、无线传感器网络领域、无线数据采集领域的产品和技术的研发。上海美嵌智能科技有限公司，业务范围涉及无线数据通信设备，自动网络通信设备、掌上数据通信终端设备、无线智能电网系统解决方案、无线智能能源系统解决方案，无线物流网络系统解决方案。上海美嵌智能科技有限公司所有业务无一不显露出创新、智慧和卓越远见。	公司	公司
《碧水微风媚太湖》是李志辉演唱的歌曲，收录于专辑《吟唱山水间》。	歌曲	歌曲
T·曼达匝TerrenceMandaza是津巴布韦的一名职业足球运动员出生于1984年8月29日效力球队为铂星场上位置为前锋	足球运动员	足球运动员
《最后一个沧海桑田》是连载于小说阅读网的青春校园类小说，作者是天鹅飞走了。	小说	小说
《末世剑行》是酒冷所写的历史军事网络小说，2008年9月最后更新，现处于连载中。	小说	小说
深圳京湖时尚酒店是位于深圳市人民南路京湖大厦的一家酒店。	酒店	酒店
《我的忘川，你的望川》是一部小说，作者是孤榭茜，连载网站红袖添香网。	小说	小说
《漫漫非人路》是一部连载中的小说，作者是尘然若梦	小说	小说
凯斯·拉斯利是一名苏格兰籍足球运动员，场上位置是中场。	运动员	足球运动员
《梨花湾的女人》是在小说阅读网上连载的一部乡村乡土小说，作者是文学天使。	小说	小说
徐庄小学始创于2004年，现有学生750人，学校建筑面积3590m2.具有高级教学设备条件，近两年学校发展迅速，吸引了大量外地打工人员子女入学。教育教学质量稳步提高。先后被评为“文化环境特色学校”、“教学质量优质校”等称号。	学校	学校
《觉》是觉小墨在2011年夏天创作的一首现代诗作品，发表在散文网。	现代诗	诗作品
未知的执着是一部小说，作者零点三。	小说	小说
枕戈击楫，成语，意思是枕着兵器，拍击船桨。“枕戈”出自东晋人物刘琨的典故“枕戈待旦”，“击楫”出自东晋人物祖逖的典故“中流击楫”。此成语可查最早出处是《明熹宗实录》：“兵部右侍郎熊廷弼功著存辽，朕已洞鉴，朝议佥同，特兹起用。方今奴酋荐食狂逞，忠臣义士岂无枕戈击楫之思？你部里便马上差官赍敕前谕本官，仍著彼处地方官敦趣，即日就道，如不顾君命，坚卧托辞，国有宪章，朕不敢贷。并升任尚书许弘纲、侍郎王在晋、祁伯裕奉命已久，都著催促前来任事，不得仍前延缓。故谕。”	成语	成语,人物
郑煜，女，毕业于中国科技大学，是华夏收入基金经理。	经理,基金经理,华夏收入基金经理	
《佐伦剑传》是连载于晋江文学城的小说，作者是萧牧天。	小说	小说
《一夕芳华》的作者是卿泠，连载于17k小说网的一部穿越架空类小说	小说	小说
《字趣》是学林出版社2004年8月出版的生活类书籍，作者胡建锋。	书籍	小说,书籍
《黑暗掌舵人》是连载于起点中文网的一本魔幻类小说，作者是黑暗掌舵人。	小说	小说
《时尚晚礼服2》是一款装扮小游戏，游戏大小为482K，游戏画面为2D画面。	游戏	游戏
《扭曲的灵魂之天使安然》作者是安然01，小说进度连载，连载网站云中书城。	小说	小说
西门子SX66是一款移动手机，标配电池为1400毫安时。	手机,移动手机	动手机
帕布罗·巴雷拉（PabloBarrera，1987年6月21日－)，是一名墨西哥足球运动员。帕布罗·巴雷拉司职前锋，目前效力于墨西哥美洲狮足球俱乐部。	运动员,足球运动员	足球运动员
贝桑松高瓦伦丁普瑞米尔经典酒店位于贝桑松，是家1星级酒店。无论您是因为出差或度假而造访贝桑松，贝桑松高瓦伦丁普瑞米尔经典酒店都会是您住宿的绝佳选择。在这里您将得到一份贴心服务、收获一份美丽心情。酒店。	酒店	酒店
藏山祠创建年代不详，金大定十二年(1172年)重修，元、明、清历代屡有修葺。祠址向南，依山建造。建筑分布于三层递高的平台上，祠前为明代“藏孤胜境”牌楼，祠内中轴线上依次布列山门、乐台、正殿、寝宫、梳妆楼，东西两侧为钟鼓楼、配殿和耳殿。除寝宫部分梁架保存金代风格外，余皆清代建筑。	建筑	
王占馥，杭州师范学院人文学院中文系教授，“汉语言文字学”硕士点硕士生导师。浙江省社科“十五”规划专家组成员。中国语言文字应用学会、中国语言学会会员、中国修辞学会会员、华东修辞学会理事。	教授,杭州师范学院人文学院中文系教授	教授
孟津火车站是位于河南孟津县平乐乡，邮政编码471135。建于1970年，是焦柳铁路上的一个车站，距离月山火车站102公里，隶属郑州铁路局龙门车务段管辖，现为四等站，该站及相邻上下行区间均为电气化区段。	车站,火车站	车站
《青天白云记》是连载于起点中文网的小说，作者是马光志。	小说	小说
易家纺是一个通过整合家纺行业各种资源，用高新IT技术手段来为家纺企业提供在线全流程服务的，贯穿整个家纺垂直产业链的电子商务服务平台。	电子商务服务平台	
巴里-邦兹（BarryBonds），美国职业棒球运动员，效力于旧金山巨人队是一名外场手，擅长以本垒打、盗垒以及守备出名。	运动员	美国职业棒球运动员
1963年出生，中医学院院长，硕士生导师，博士生导师，中国中医药学会中医基础理论分会副主任委员，中国中西医结合学会中医外语专业委员会委员，天津中医药学会肿瘤专业委员会副主任委员。	院长	副主任委员
《严霜之城》是一部连载于起点中文网的网络小说，作者是苹果与天平。	小说	小说
深圳市汉智星科技有限公司成立于2000年，公司总部设立于深圳经济特区，是深圳市政府重点扶持的IT民营企业。公司专业从事MINI-ITX主板的研发、生产、销售。公司产品广泛应用于：自助银行终端、商超营业系统、网络服务器、智能游戏终端、自动化医疗设备、物流应用设备、防火墙等领域。公司本着“以质量为依托，以服务创佳绩”的营销理念，推出拥有自主知识产权的研域工控系列MINI-ITX主板产品。远销欧美、中东、北非、东南亚等四十多个国家和地区，已成为国内外知名主板品牌。	公司	游戏,公司
《皇上，请赐妾一封休书》是连载于红袖添香网的小说，作者是羽璃玥。	小说	小说
恩戈西·恩特尔赫，男，是一名足球运动员，场上的位置是后卫。	运动员	足球运动员
榎本贵音，为Jin（自然之敌P）所创造的一项多媒体project系列《阳炎计划》中的主要人物之一。在作品是吉祥物一般的存在，在与NTTdomoco合作中，将ENE这一电子安宠角色加入了对话软件“しゃべってコンシェル”中。活泼开朗喜爱吐糟的少女，有些毒舌。是生活在如月伸太郎的电子通讯中的电子生命体，并称其为“主人”。目隐团团员，编号为NO.6。能力为“目觉”。	人物	软件,人物
施永生，男，上海市人，1957年生，工学博士，教授，硕士研究生导师，云南省土木工程学会给水排水专业委员会副主任委员，全国高等学校给水排水工程专业指导委员会委员。	教授,硕士研究生导师,工学博士	教授,学校
《雾梦蒙》是晋江文学城连载的随笔小说，作者是HarinBaby。	小说	小说
《龙神异界维和记》是由晶逝潇写的一本关于玄幻类型的连载于好123小说的小说。	小说	小说
上海培行企业管理咨询有限公司是专为企业和个人提供培训和咨询服务的专业咨询机构·	公司	公司
《长明》是一部连载于晋江文学城的古色古香小说，作者是悠然无常。	小说	小说
《封魂罐:古玩界那些不散的幽魂》是在搜狐读书网上连载的一部小说，作者是铁鱼。	小说	小说
《美梦如初爱心依旧》是一部小说，作者是易净，连载网站17k小说网。	小说	小说
碾骨胸铠是网络游戏《魔兽世界》中古代王国掉落的。	游戏	游戏
深圳市龙珠中学于2006年9月1日由深圳市政府投资兴建的公办初级中学，隶属于南山区教育局。学校坐落在塘朗山森林公园脚下，占地3万余平方米，建筑面积1.43万平方米。校园环境幽美，设施一流。有各种配套齐全的功能室和室内体育馆，并建有深圳市唯一的具有国际标准的棒球场。	学校	学校
上海思英化工科技有限公司坐落于上海市闵行区吴泾科技园，紧邻上海紫竹科技园和闵行工业开发区，是依托美国知名化学及药物研发机构，具有独立知识产权的创新型高科技企业。发展态势良好。	公司	公司
《守护甜心之守护一生》是连载于小说阅读网的一本同人其它小说，作者是月蝶星。	小说	小说
《为艾而生》是起点中文网连载的一部小说，作者是Aiks艾克斯。	小说	小说
《仙帝凡修》是在纵横中文网连载的小说，作者是随二。	小说	小说
《小鹿斑比》是由詹姆斯·阿尔格等执导，哈迪·奥尔布赖特、蒂姆·戴维斯、斯坦·亚历山大等配音的迪士尼动画电影。该片于1942年8月21日在北美上映，是迪士尼制作的第五部长篇动画片。影片讲述了一只叫斑比的小鹿经历了欢喜与忧伤，失去了亲人和家园，克服困难茁壮成长的故事。2011年，该片被美国国家电影保护名录和美国国会图书馆保存名录永久珍藏。	电影,动画	动画电影
《村里好多人》是云中书城连载的小说，作者是夏院。	小说	小说
旋梭是缝纫机的重要组成部份，旋梭形成线迹的原理与摆梭基本相同，但它的形成线迹的过程和方法与摆梭又有不同。	重要组成部份	
妖娆戏周草是小说名称，作者是春雨若微，小说进度连载。	小说	小说
杨连霞女士，生于1968年9月，大学本科，热能工程专业毕业，工程师，注册造价师执业资格。2001年至2005年4月就职于南京新华船舶股份有限公司基建科；2002年5月至2005年12月在苏宁环球集团任集团预算部副经理。现任公司职工代表监事	工程师	公司,工程师
《莲の旅程》是连载于晋江文学城的一部动漫同人类小说，作者是宫野月。	小说	小说
福岛樱，（拉丁学名：Prunusserrulata），蔷薇科梨属植物。福岛樱花色幽香艳丽，为早春重要的观花树种，常用于园林观赏。	植物	植物
《召唤匹夫》是连载于起点中文网的小说，作者是败笔书童。	小说	小说
莱比岛公立中学位于澳大利亚昆士兰州，学校类型：高中。布莱比岛公立中学是一所不断进步的学校，为学生提供优异的教育帮助他们成功步入未来。学校最突出的特点之一是恰当而广泛的支持体系，通过加强学生-教师-家长间的积极合作，使学生的学习成绩得以提高。布莱比岛公立中学另一特色以优异的信息与通信技术为支撑的高质量的教学与学术。	学校	学校
潍坊联运有限责任公司前身成立于1986年，下设15个二级经营单位和5个独立法人单位，拥有1个一级客运站、1个一级货运站和3个物流园区，是同时具有二级客、货运经营资质的大型综合运输骨干企业、全市重点物流企业。2002年通过了ISO9001：2000国际质量管理认证，业务上逐渐形成了以公路客运和现代物流两大中心业务为支柱，以驾驶员培训、房地产开发、二手车交易、汽车出租、服装制作、旅游客票、汽车修理等为支点的综合联运服务体系。	公司,有限责任公司	公司
公司成立于2003年，是集设计、制造、销售、服务于一体的科技型公司，旗下优泰品牌是全国知名商标，消费者信得过品牌，其销售网络遍布湖南各地以及辽宁、河北、甘肃、河南、湖北、江苏、山东、江西、浙江、云南等省份。	公司	公司
BryketEisner.1934.Unknown.Parnassiana,3:25-25.武春生.2001.中国动物志昆虫纲第二十五卷鳞翅目凤蝶科.北京:科学出版社.:1-367.	动物	动物
《康斯坦湖的魔戒》是一本原创小说，连载于晋江文学城。作者：虹色鸢尾	小说	小说
《花冢祭》是连载于起点中文网的一部推理悬疑类小说，作者是玥儿萍。	小说	小说
《深圳不得不说的故事》是在小说阅读网上连载的一部小说，作者是陈羽菲。	小说	小说
利物浦戴尔街宜必思尚品酒店位于利物浦，是家3星级酒店。无论您是因为出差或度假而造访利物浦，利物浦戴尔街宜必思尚品酒店都会是您住宿的绝佳选择。在这里您将得到一份贴心服务、收获一份美丽心情。酒店，距离阿尔伯特港口步行15分钟。	酒店	酒店
西方红疣猴，中文别名西非红疣猴，哺乳纲动物。分布于科特迪瓦，冈比亚等。	动物	动物
萧振高级中学创办于1995年，坐落于中国信用第一镇--萧江镇，学校紧邻104国道，交通十分便利。校园占地面积27757平方米，建筑面积21000多平方米，现有教学班级26个每个班50来号人，在校学生1176人，专任教师82人，教师学历合格率达98.8%，中高级职称教师占90%。	学校	学校
《何必轻叹》是采萱创作的一部网络小说，连载于小说吧。	小说	小说
蝶翼是一位蝶妖。姐姐蝶翼，妹妹清影，本是傲来村的两只蝶妖。五千年前的谷雨时节，王母将姊妹俩收服，将她们的魂魄化为镜面两侧的两只蝴蝶浮雕。王母期待她们化仙后，能成为蟠桃园桃花丛中的守护花神。半夜时分，舞彩娥不小心伏案睡着。烛火烧着了屏风，烈焰波及七色绸缎。待姊妹俩从梦境中惊醒过来，火焰已如波涛汹涌翻腾。她们必须提前将真元从蝴蝶浮雕中挣脱而出，否则只能葬身火海，五千年道行瞬间化为乌有。蝶翼为了阻止妹妹不断的复仇，并恢复容貌，她用尽了自身的修为至死，帮妹妹回复了容貌。	蝶妖	
《落在肩膀上的羽毛》作者是_____记忆，小说进度已完结，连载网站小说阅读网。	小说	小说
广州珠吉酒店地处广州市天河区东圃珠吉街东环路繁华地段，地理位置优越、交通便利。各路公交车站近在咫尺，地铁五号线也在酒店周边附近。周边有奥林匹克、世界大观等著名景区。酒店集清新、典雅、别致的风格，现代、文化、艺术的特色，温馨、舒适、优质的服务于一身，是中外宾客来广州旅游观光的理想住处，从事商务活动的上佳选择。	酒店	酒店
《涂鸦跑酷》是一款动作小游戏，发行时间为2010年04月03日。	游戏	游戏
武汉大唐国际旅行社有限公司，自2005年成立至今，发展为一家在华中乃至全国都知名的国际旅行社，成为中国旅游协会会员企业，武汉地区首家进入中国国内旅游百强的企业，省市旅游局联合推荐优秀旅游企业。公司位于江岸区黄石路特1号汉港大厦6楼D座，经营许可证号：L-HUB-CJ00040	公司	公司
《两年前若只是初见》是17k小说网连载的青春校园小说，该书作者是谢欣言。	小说	小说
公司成立于2003年9月6日，计划投资建设3条新型干法水泥熟料生产线、年产450万吨水泥生产线、4.5公里铁路专用线和18000kW低温余热发电项目，同时配套建设110kVz总降压变电站。2005年8月22日，首条5000t/d熟料水泥生产线建成投产。	公司	电站,公司
李林，男，现年91岁，山西洪洞人。民族脊梁抗战老兵。	老兵	
哈鲁纳·巴班吉达（HARUNABABANGIDA），尼日利亚足球运动员，司职前锋。曾入选尼日利亚国家队。曾在阿贾克斯青年队、巴塞罗那B队效力。曾效力于美因茨足球俱乐部、维特斯足球俱乐部，并先后效力于乌克兰、希腊、塞浦路斯、俄罗斯和奥地利联赛。2015年1月18日加盟马耳他莫斯塔FC足球俱乐部。尼日利亚球星蒂贾尼·巴班吉达的弟弟。	运动员,足球运动员	足球运动员
《暗光交接乐队梦》是17k小说网连载的都市言情小说，作者是星闪舞。	小说	小说
平壤之战是甲午中日战争中的一场重要战役，于1894年9月15日在朝鲜平安道首府平壤进行，是日本驱逐清朝在朝鲜的势力的决定性作战。1894年9月初，日军开始向平壤推进，参战部队共16000余人，清军防御部队为15000余人。日军至9月15日完成部署，随即展开进攻，经过一整日激战，清军在船桥里击退日军，日军则攻下平壤北边的战略要地玄武门和牡丹台，其后清军抛弃辎重仓惶撤退，撤退途中屡遭日军伏击，撤退后又没有可以依托的防御支撑点，伤亡惨重。至9月24日，清军全部退回中国境内，日军大获全胜。9月15日平壤之战与9月17日的黄海海战一起，成为中日甲午战争的转折点，自此以后，日军掌握战场主动权，开始在中国境内迅速推进。平壤之战中，山东费城杰出将领左宝贵面对友军溃逃、敌军压境的境况，毅然殊死抵抗，直至殉国。皇帝由此，赠太子少保衔，予谥忠壮。	战役,甲午战争	
《前世今生海潮儿》是晋江文学城连载的小说作品，作者是格格0307。	小说,小说作品	小说作品
常绿乔木，高4-10米或更高。单叶互生而丛生于枝端，常于新叶开放时，老叶全部凋落，因有“交让”木之称；花小，淡绿色，成短总状花序，雌雄异株；雄花不具花被而有长梗，雄蕊8-10，花丝短；雌花有花被片8-10，子房2室，柱头上密生深红色柔毛，花后变黑色。核果长椭圆形，黑色，外果皮肉质，内果皮坚硬。花期3-5月，果期8-10月。此树虽为赏绿，然当翌春新叶开放之初，老叶始全部祠零，’绮凝交替现象，交让之名，盖缘于是。4--5月间，开深黄色小花，雌雄异株。果实为椭圆型。叶和种子可以药用，治疖毒红肿；因树冠及叶柄美丽，亦可庭院栽培观赏。该物种为中国植物图谱数据库收录的有毒植物，其毒性为树皮有毒，煎汁可作驱虫药，动物食后可致死。	植物	植物
灵鹫功是游戏《天龙八部2》里的天山门派第一本技能书（秘笈）的名称，旗下包括雁南飞、鹰击长空、冰肌玉骨等三个心法技能。从各种神禽灵鹫的动作形态中化出的神功，出手狠辣，毫不容情，修习之后可以提升天山弟子的命中率。	游戏	游戏
上海西恩迪蓄电池有限公司是由美国西恩迪科技有限公司与上海输配电股份有限公司共同投资组建的专业生产阀控铅酸免维护蓄电池的生产商。公司是著名铅酸蓄电池品牌LIBERTY（原DYNASTY大力神）在中国的唯一生产制造商。	公司	公司
深圳市友田达实业有限公司创建于1995年8月，是深圳最早的桶装水服务公司之一。主营桶装水及相关产品，是“华润怡宝”桶装水深圳地区经销商。	公司	公司
农家小白菜是一道美食，主要用料是小白菜等。	美食	
《高三不高三》是连载于晋江文学城的一部小说，作者是央少。	小说	小说
埃斯皮拉纳巴西利亚酒店位于巴西利亚，是家4星级酒店。	酒店	酒店
《穿越—皇后武功盖世》是新小说吧连载的小说，作者是残雪闻莺。	小说	小说
向书坚，男，1963年1月出生，籍贯湖南，中共党员，中南财经政法大学研究生部主任；信息学院统计系教授、博士生导师。研究方向主要是统计理论与方法、宏观经济统计分析、国民经济核算理论与方法、收入分配问题、居民消费结构问题等。	教授	教授
《重生之都市三国》是起点中文网连载的都市小说，作者是天地的信徒。	小说	小说
1988年2月出生于德国莱比锡，足球运动员，场上位置后卫，效力于爱尔福特红白。	运动员,足球运动员	足球运动员
恩施论坛是所属恩施在线网站子频道，提供房屋租售、求职招聘、交友婚恋、二手交易等分类信息服务的大型社区论坛网站。	网站	网站
半块铜板执笔，玄幻类型的网络小说，由3G小说网首发连载中。日点击：241，总点击：586877，日推荐：17，总推荐：1162，全文字数：179.1万，连载状态：连载中。等级划分：武道四大境界，武道境分七重，虚、气、真、灵、玄、天、神、玄道、天道、神道而玄道、天道、神道又各分四境、一境七重玄道境：凝真、生丹、冲识、凌虚天道境：妙渡、承道、乾坤、道武至一神道境：入尘、化尘、太尘、碎涅	小说	小说
杨暨（？—？），字休先。河南荥阳（今河南省荥阳市）人。三国时魏国大臣。官至中领军。卒谥曰肃。	中领军	
普里瓦，是一名法属圭亚那足球运动员。	运动员,足球运动员	足球运动员
《暗黑帝国》是一款游戏，鼠标操作。标签是暗黑帝国策略防御RPG角色扮演战争。	游戏	游戏
庆泰大饭店位于台北，是家4星级酒店，距离台北101大楼打车11分钟，车程约6.0公里。	酒店	酒店
天津中信国际旅行社是经国家旅游局批准的具有出境资格的组团社。是中国中信集团所属的中信旅游总公司控股公司。	公司	公司
《我的温柔只为你》是连载于晋江文学城的一部小说，作者是水若梅。	小说	小说
《义狗忠心》是连载于起点中文网的一部小说，作者是fxd山鹰。	小说	小说
清华大学水利系教授曾是清华大学水利水电工程系学士、硕士中国水利水电科学研究院博士现任教于清华大学	教授	
somethingwrong是BangGang演唱的专辑，民谣曲风。	专辑	专辑
三星GalaxyGear是由韩国三星电子研发的一款智能佩带设备。该款产品于2013年9月4日正式发布。	设备	
《情侣学院》是起点中文网连载的小说，作者是Angle小杰。	小说	小说
2007年新丝路中国模特大赛季军	模特	
游戏《PokeMon》人物，电玩珍珠·钻石·白金版与主角结伴旅行的NPC，聪明伶俐、古灵精怪、颇有点人小鬼大的少女，身份为神奇宝贝训练师。	人物	游戏,人物
西藏银莲花（学名：Anemonetibetica）是毛茛科银莲花属的植物，是中国的特有植物。分布在中国大陆的西藏等地，生长于海拔3,100米的地区，多生长于山谷沟边，目前尚未由人工引种栽培。	植物	植物
汝阴即春秋胡子国（在今安徽省阜阳市颍州区鼓楼街道北部和颍泉区农机校以南300米处。），秦统一六国设立郡县制，全国41个郡，汝阴县属于陈郡。东汉时汝阴县属为汝南郡。汝阴郡地处中原腹地，为军事重镇。失去汝阴，则江南不保，晋灭吴、侯景灭梁、隋灭陈、宋灭南唐都是典型的例子。历史上许多有名的战事也发生在这里。三国时魏将张辽大败孙权十万大军的逍遥津战役；南北朝时梁将韦睿水攻破汝阴；永初三年（422年)，北魏趁宋武帝刘裕死，发兵淮北，占领汝阴郡之战。	历史	
百大易商城是合肥百大集团旗下从事电子商务运营的公司，作为百大集团零售转型“第四大业态”于2011年11月24日正式上线。2013年11月28日，百大易商城转型升级，定位“同城网上超市”，以发展超市O2O为起点，打造百大集团整个线上线下的O2O平台。	公司	公司
南宁方圆图书店是广西区内网络销售图书最大、最专业的考试书店；主要是大学生，考试书籍需求量大、独立的临街楼面店名豁然醒目，书店交通便利，读者亲自前往可以轻松到达；店堂宽敞明亮，各个书架排列井然有序，图书分类陈列，为顾客提供一个舒适、方便的购物环境；本着一切为顾客服务的原则，工作人员能随时为顾客提供帮助解答问题，并在店内提供休息阅读区，使顾客能安心的翻阅自己所需的读物；店内实行红外线扫描收银，既能提高收银的准确性，又能为顾客节省交款时间。同时也可以登录南宁方圆图书网，进行查找您想要的书籍。	书店	书籍
拉伊卡·奥利维拉，巴西模特，1984年1月22日出生于巴西尼泰罗伊。曾是时尚杂志《Vogue》、《ELLE》、《富贵场》的模特。	模特	
霹雳布袋戏虚拟人物罪恶坑杀手，与向日斜一刀一剑，立侍于狂龙左右，奉命监视投诚的公孙月。	人物,虚拟人物	
奥尔林·奥兰多·佩拉尔塔·冈萨雷斯，足球运动员，洪都拉斯人，踢后卫，惯用右脚，效力于洪都拉斯的莫塔瓦俱乐部。	运动员,足球运动员	足球运动员
程军高，电影制片主任，参与制作过的电影有《抬花轿》、《国魂》等。	电影制片主任	电影,电影制片主任
管用和，男，1937年生，湖北孝感市人。当过教师、文化馆干部、编剧。中国作家协会会员，中国音乐家协会会员。系文学创作一级作家，享受国务院政府津贴。曾任湖北省作家协会副主席，武汉文联副主席，武汉作家协会主席。1956年发表美术作品，次年发表文学作品。1982年加入中国作家协会。迄今已出版诗歌、散文等文学作品25集。著有诗集《欢乐的农村》（合集）、《山寨水乡集》(合集)、《公社大地》、《彩色的童年》、《水乡风采》、《管用和诗选》、《湖北作家文库管用和卷》、《小玲玲的诗》；散文诗集《潮沫》、《火莲》、《细流与暮雨》（合集）、《露珠集》、《滴水集》、《恋情初萌》、《自然·情思》；儿歌集《公社儿歌》（合集）、《幼儿歌谣一百首》、《宝宝好习惯儿歌一百首》(合集)；童话诗集《小鲤鱼找珍珠》；散文集《萤火》；唱词集《一包茶》、《一担新箩筐》及文集《管用和文选集》等。诗集《小鲤鱼找珍珠》获湖北省1949－1979年优秀作品奖；组诗《小玲玲的诗》获1992年《儿童文学》优秀作品奖、湖北省1980-1985年儿童文学奖；散文《紫砂陶壶》获全国第三届报纸副刊好作品三等奖；《红花草之歌》获全国第八届报纸副刊优秀奖。其作品入选《中国新文艺大系》诗歌集、散文集、儿童文学集等180余种选集。此外，还在《中国文化报》、《湖北日报》、《长江日报》等刊物上发表美术作品300余幅，书画作品曾在中国美术馆参展，在武汉举办过个人画展。	作家	音乐家协会会员,美术作品,作家,教师
安徽大学磬苑校区即安徽大学新校区，位于合肥经济技术开发区大学城，因大学整体轮廓如古代的打击乐器磬（读音qìng），故得名“磬苑校区”。学校之育人犹是，其育人与育人成效如何，全赖管理施教者能动作用之发挥。以击磬成乐喻学校育人使之成才，此寓意一。磬音清亮，悠扬婉转，编组击之，和而成乐。学校管理施教，化蒙成材，亦不离“和谐”二字。德与才之和谐，思与行、学与行之和谐，领导集体、管理队伍乃至全体师生员工心之和谐，教学与科研、产业之和谐，学科间之和谐，如此等等。	学校	学校
《九骨战魂印》是笔辰写的网络小说连载于17k小说网。	小说	小说
平遥古城藏报博物馆，座落在明清街鸡市口的繁华地段，建筑保存了明清时期的风格，古色古香，雕梁画栋，总投资200余万元。藏报数量6万余种，110余万份，馆藏报刊已载入世界吉尼斯之最纪录大全。	建筑,博物馆	博物馆
湖南天心教育文化服务有限公司成立于2010年，是一家新型的、现代化的电子商务运营及文化服务的公司。公司致力将旗下的天心商城打造成为湖南省最大的电子商务购物平台，将旗下的天心阅读文化网（原名天心阅读网）打造为国内最专业的阅读文化推广机构；公司文化核心是“天心”，“天心”源于张载的“为天地立心，为生民立命，为往圣继绝学，为万世开太平”。	公司	公司
《仗剑江湖录》是起点中文网上连载的一部小说，作者是浅杉。	小说	小说
《网游之武逆乾坤》是在纵横中文网连载的一部小说，作者是暗夜觉罗河。	小说	小说
公司是一家专业投影机/灯泡销售和投影机租赁与维修服务的公司。公司位于湖南省长沙市车站路凯旋国际大厦A栋1802。	公司	公司
《血战湘江》是由陈力执导，保剑锋、王霙、孙维民、张一山、耿乐等主演的战争史诗电影。影片讲述了1934年红军34师官兵付出巨大牺牲奋力掩护党中央渡过湘江、成功突破封锁的悲壮故事。影片于2017年6月30日在中国上映。	电影	电影
广东省民政职业技术学校是省教育厅直属的国家公办全日制中等职业学校，办学25年来，学校秉承“授技育人，培养现代技术、现代服务、现代管理职业人才”的理念，开设有传统与新兴产业急需人才的专业17个，拥有先进的多媒体电教设备、一流的省级示范性实训中心和素质优良的双师型教师队伍。部分专业设置独具一格，毕业生素质过硬，已成为多家企事业单位和社会服务机构与我校签约委托培养的专业；学校实行“双证”、“双学历”教育，学生可根据个人爱好和需要选修或参加计算机办公软件、网页制作、图形图像、汽车维修等技能及会计电算化上岗资格考证，可同时报读我校与中大、华师等院校合办的行政管理、社会工作、动漫制作、电子政务、会计电算化、艺术教育等专业的自考、成人教育大专。中职毕业后也可直接报考省教育厅指定与我校招生对接的15所高职院校。学校就业指导中心为学生精心规划职业生涯，在广州地区推荐就业率达98%以上。	学校	学校
郭中一，大学教授，智上文教机构董事长，合肥智上农业开发公司董事长；教育方面，郭中一教授是台湾东吴大学物理系副教授，国内多所大学兼职教授、研究员，亳州药都学校校长；政治方面，是台湾反军购联盟召集人等。	大学教授	教授,研究员,学校校长
《连云港和顺祥珠宝有限公司》所属和顺祥，连云港。	公司	公司
孙耀鲁，男，1963年7月出生，副教授，信息科学与工程学院计算机系教师。	教授	副教授,教师
玛丽亚住宿加早餐酒店位于比萨。玛丽亚住宿加早餐酒店让您在比萨这个陌生又熟悉的城市，感受到一丝清浅但又实在的温暖。您一定不能错过。酒店，距离比萨斜塔步行18分钟，或打车8分钟，车程约4.6公里。	酒店	酒店
莉雅，是网络小说《风姿物语》女主角，作者是罗森。	主角,女主角	小说
《异界之霸道的戒指》是青年好好青年写的一部异界大陆类小说。	小说	小说
《书凡》是发表于网络的都市小说，作者是半盏清茶。	小说	小说
伍青生博士是上海交通大学安泰经济与管理学院的副教授，硕士研究生导师，美国哥伦比亚大学的高级访问学者。	学者	副教授
SuperProxy代理服务器V3.63是一个功能强大，速度快，稳定性和安全性较高，适合家庭用户，从事网吧的用户，企业和公司用户共享上网的需要的成熟产品。	稳定性	公司
宇如聪，汉族，1962年3月生，安徽全椒人，无党派，1979年9月参加工作，中国科学院大气物理研究所气象学专业研究生学历，理学博士，研究员，博士生导师。现任中国气象局副局长。	中国气象局副局长,研究员	博士生导师,副局长,研究员
阿卡尔酒店位于阿姆利则，是家1星级酒店。阿卡尔酒店让您在阿姆利则这个陌生又熟悉的城市，感受到一丝清浅但又实在的温暖。您一定不能错过。酒店。	酒店	酒店
陈园学校现在是一所风景秀丽、环境优美的花园式学校。新学期开学以来，在以秦坤校长为首的学校领导班子的带领下，全校师生你献计我献策，齐动手齐努力，把学校建设成为一所花园似的学校。学校坚持时时刻刻、角角落落打扫环境卫生，保持清洁；及时栽种花木，增加绿化面积；利用双休日义务劳动，刨土浇水，养护花草树木；粉刷墙壁，绘图写字；制定诗文匾牌，营造文化氛围；	学校	学校
《修真要原创》是连载在起点中文网上的一部小说，作者是林中燕。	小说	小说
《神盘》是起点中文网连载的东方玄幻小说，作者是嬴大政。	小说	小说
莱州三维集团公司莱州市精细化工机械设备厂位于风景秀丽、物产富饶的胶东半岛莱州湾畔，地处经济繁荣的路旺镇，交通便利，是机械工业部设备定点企业。公司现有员工480余人，固定资产5000余万元，占地面积86000平方米。集团下设发酵设备研究所、绿色能源设备研究所、三维机械设备有限公司、精细化工机械设备厂、轻工塑料机械厂、干燥机械设备厂、酵母饲料厂、塑料制品厂等八个企业。拥有各种专业技术人员和专业测试设备。集科研、生产、服务于一体的高科技企业。技术力量雄厚，产品畅销全国各地。部分产品已出口到东南亚、欧美等国。被授予“山东省高新技术企业”、“山东省重合同守信誉企业”称号。集团坚持以技兴业，以质取荣、以信赢客、以优取胜的企业精神，与广大客商携手共创辉煌的明天。	公司	公司
《弑神列传》是一部由网络写手”生于夏末“创作的东方玄幻类小说，此书曾在起点中文网连载，目前已停更。	小说	小说
费城科学大学，建于1821年，位于宾夕法尼亚州的费城，是一所私立的、全面的、男女同校的大学，学校主要提供药品和其他各种与健康有关的学科方面的学士、硕士、博士学位。	学校	学校
马头岭九年制学校的前身是马头岭中学，创建于1958年，根据学校布局调整规划，在2003年完成了中心完小与中学合并，办成了九年制学校。学校占地面积14000平方米，建筑面积5793平方米，绿化面积1023平方米，绿化覆盖率73%。	学校	学校
江苏华虹新能源有限公司位于长江三角洲的世界科技示范城常州市漕桥镇，依托上海，紧临南京，交通便捷。公司是致力于高科产品开发研制应用的高新技术企业。	公司	公司
私立大学（PrivateUniversity，或称民办大学）是指主要由民间资本所维持经营的大学，一般是指由非地方或者中央政府投资，全部或者部分的依靠学生的学费来维持大学的经营而非公共资金，而且校方有权自主选择生源的大学。私立大学的学费是公立大学的三到四倍。其主要经费来源仰赖学费、捐款、募款等非政府资金，以维持其独立非营利组织之特性。然而私立大学接受政府资金亦属寻常，如美国康乃尔大学有四座学院仰赖联邦政府的补助，“威胁”缩减政府补助亦能改变哈佛大学的既定政策。	大学	
冒险王变态版是一款冒险小游戏，15.6M(大小)	游戏	游戏
储智博，1956年1月3日出生于河北秦皇岛，祖籍天津，中国内地影视男演员。1987年，参演个人首部电影《闪电行动》，从而进入演艺圈。1989年调入海政电视艺术中心。2000年凭借电视剧《西藏风云》获得“金鸡奖”十佳男配角奖提名，中国电视报“观众最喜欢的男演员”十佳男配角提名。2007年与王姬、丁嘉丽共同主演电视剧《男人立正》。2009年1月出演电视剧《走西口》。同年3月，主演电影《周末村官》。2011年9月参演电视剧《致命名单》。2012年9月参演电视剧《致命名单》。2014年7月主演励志轻喜剧《错儿》。2015年2月，出演都市悬疑剧《别让我看见》。2016年9月，主演剧情片《吕梁汉子》。	演员	演员
深圳德盈华叶是国际化财富管理综合解决方案服务商，总部位于深圳福田区。公司始创于2006年，2008年开始拓展金融服务和财富管理，公司拥有中国证监会核发的互联网基金销售牌照，广东省人力资源和社会保障厅、民政厅等颁发的培训学院牌照，中国证券投资基金业协会私募投资基金管理人备案以及其它相关的经营牌照和资质。	公司	公司
《伤痕痊愈幸福初降临》是连载于小说阅读网的一本青春校园类小说，作者是凌影汐。	小说	小说
中医云火活肾疗法，是以祖国医学的艾灸·导引·推拿为基础，结合现代高科技医学手段，以“药火”为诱导，对人体特殊穴位进行中医特色治疗的方法。	疗法	
《威斯朗大陆之歌》是晋江文学城连载的小说，作者是迦龄。	小说	小说
VisualBasic编程语言（VB）中的一个属性。Flags属性（“打开”、“另存为”对话框），为“打开”和“另存为”对话框返回或设置选项。cdlOFNExplorer和cdlOFNNoDereferenceLinks标志适用于Windows95和WindowsNT4.0。Windows95中cdlOFNExplorer的公共对话框使用字符作为分隔符；而在没有Windows95外壳的WindowsNT的早期版本中，多重选择是使用空格作为分隔符（固而不能支持长文件名）。另有同名歌曲FLAGS。	语言	
李子园社区位于江西省萍乡市安源区凤凰街道，地处萍乡市城区中心地段，是市委市政府机关所在地，常住人口7436人，有驻社区单位15个。近年来，李子园社区努力实践“三个代表”，加大社区建设力度，促进了社区各项工作有声有色地进行。李小园社区将牢记胡总书记的”两个务必“，以“三个代表”的精神为指导，大力拓展社区服务，发展社区经济，繁荣社区文化，加强社区治安，努力营造成一个管理有序、服务完善、环境优美、治安良好、生活便利、人际关系和谐的文明社区。	社区	社区
费恩罗福特麦拉卡-海瑞泰至旅馆位于马六甲。费恩罗福特麦拉卡-海瑞泰至旅馆是您来马六甲的最佳落脚点。这里，将一份温温软软，悄然安放于旅行的希冀之中，您定不会失望。酒店位置较好，距离荷兰红屋步行9分钟。	酒店	酒店
文彦，汉语词语，意思是有文才德行的人。	词语	词语
《腹黑王爷的绝色弃妃》是一部网络小说，作者为狐狸小姝，已完结。	小说	小说
毛喆喆的一部言情类小说，目前连载于红袖添香网。	小说	小说
《天生要不要一对》是猫小黎所著的一本图书，小说类型是都市言情，在起点中文网连载。	小说	小说
特权酒店位于佛罗伦萨，距离圣母百花大教堂和洗礼堂步行16分钟。	酒店	酒店
《艾里布达传媒帝国》是连载于起点中文网的小说，作者是不见迷迭香。	小说	小说
《猎魔奇兵》是连载于起点中文网的网络小说，作者是梦叶。	小说	小说
大地村民委员会，属于坝区。距离村委会0.00公里,距离镇1.00公里，国土面积3.22平方公里，海拔1735.00米，年平均气温17.00℃，年降水量689.00毫米，适宜种植烤烟、水稻、蔬菜、花卉等农作物。有耕地1074.00亩，其中人均耕地0.63亩；有林地2107.00亩。全村辖4个村民小组，有农户489户，有乡村人口1706人，其中农业人口1651人，劳动力986人，其中从事第一产业人数671人。2014年全村经济总收入9949.00万元，农民人均纯收入10486.00元。农民收入主要以第二、三产业为主。[1]	委员会,村民委员会	
扬州市交通产业集团有限责任公司（原扬州交通产业投资有限责任公司）是由扬州市人民政府出资设立的专司国有资产经营管理的国有独资有限公司，代表市政府对授权范围内的全资、控股、参股企业行使出资者权力。	公司	公司
私密相册是一款图像软件。	软件	软件
《猫咪公主换装》是一款装扮小游戏，游戏大小为1128K。	游戏	游戏
曹彪（195年—251年），字朱虎，三国时期曹魏皇族，曹操之子。216年，曹彪被封为寿春侯。221年，曹彪进爵，升迁为汝阳公。222年，升为弋阳王，同年又升为吴王。224年，改封寿春县。226年，魏明帝即位，升迁，徙封地在白马。232年，改封楚王。嘉平三年（251年），因与王凌密谋废帝事败，被赐死，享年五十七岁。	楚王	
陈振兴（Zhen-XingChen），男，1965年7月生，湖南新化人，工学博士。陈振兴，邱运仁，等。外加热自然循环式蒸发实验装置。陈振兴，王零森。纳米级片状铜锌合金粉及其制造方法学工程学院教授，博士生导师，兼任国家科学技术奖和国家科学技术学术著作出版基金会议评审专家，JournalofNaturalGasChemistry和TransactionsofNonferrousMetalsSocietyofChina等杂志的审稿人。	教授	教授
《狩猎星辰》是2012年发行的小说，作者是齐太白。	小说	小说
中国大陆电影《省港狂龙》由洪锋执导，张琪、徐东方等出演，1989年上映。电影主要讲述，青年洪伟华错拿了毒贩李彪的箱子，并将箱子放在了同学梁展鹏的家中，展鹏发现了箱子中的毒品，悄悄将毒品拿走，而伟华却不知情。李彪知道后，命好友白金龙杀死了展鹏之父。展鹏知道后，拉响手雷，与金龙同归于尽。	电影	电影,毒品
葛根苍耳茶是来源传统药茶方的用于风湿痹痛的茶方。	茶	茶,茶方
博威仪器公司是一家集研发、制造、销售和服务为一体的高科技公司，多年来，在与客户沟通的过程当中，根据客户多样化需求、非标产品的开发、及为客户维护各种同类产品的服务中，累计了大量的设计、生产、技术改良、检测、计量售后服务的全方位经验。为了满足客户的生产需求，我们秉持【诚信、品质、专业、服务】的政策和【永远为顾客最大利益着想】的信念，使顾客以最少的成本获得最大的收益，顾客的满意是我司最大的成就。敝司全体同仁本著以信誉求发展，以品质求生存，在管理和技术等方面都做到全方位的贴身服务。	公司	公司
《南苑心惑》是连载于起点中文网的穿越架空类小说，作者是蘑菇包。	小说	小说
杜一白（1933.7-）男，湖北省黄陂市人。辽宁大学中文系教授。	教授	教授
东莞大同塑料制品有限公司是香港大同机械企业有限公司属下成员公司之一。香港大同机械企业有限公司成立于1958年，跟随香港工业的蓬勃发展，得以茁壮成长，并于1988年在香港联合交易所主板挂牌，成为一公共公司（大同机械，股份代号：118.HKex）。	公司	公司
浙江省天台中学创办于1906年，初名“天台中学堂”，1912年改名为“天台中学校”，后历经天台县立初级中学、天台县立中学，1953年2月，改名为浙江省天台中学。浙江省天台中学在1981年被列为浙江省重点中学，1997年被列为浙江省一级重点中学，2014年被列为浙江省一级普通高中特色示范学校。截至2013年，浙江省天台中学占地356亩，共有教学班58个，学生2455名，教职工246名。	学校	学校
1983年，这是MichaelJackson（迈克尔·杰克逊）一手遮天的一年，他的唱片的销售数字象计时器一样一刻不停地增多。而就是这一年，一支来自英国谢菲尔德的重金属乐队DefLeppard（戴夫·莱帕德）把一张名为《Pyromania》（纵火狂）的唱片带入美国，这支冠以“不列颠新浪潮重金属”乐队的唱片，立即招致无数歌迷的疯狂购买，销量达到了不可思议的地步。配合新潮MTV的强大宣传攻势，这张专辑所向披靡，最终卖出了一千万张！这彻底确立了DEFLEPPARD重金属王者的地位。	专辑	
《综漫花神来临》是连载于晋江文学城的小说，作者是毒女毓児。	小说	小说
浙江东鹏船舶修造有限公司位于舟山市六横岛东北部。锚地港口开阔，是船舶常年避风的深水良港，水陆交通方便，自然环境良好，三面环山，一面临海，远离居民区，是一个得天独厚的船舶修造基地。	公司	公司
曹剑新，男，1955年出生于衡阳市，在雁城衡阳得画事启蒙，毕业于湖南师大美术系中国画专业，曾入上海师大专修水彩画二年，师从朱辉、殷保康、金立德教授，现为深圳市美协理事，罗湖区文联委员、罗湖美术书法家协会主席。	主席	教授
《阿飞传人在异界》是连载于起点中文网的小说，作者是贵烟。	小说	小说
杨良准，教授，硕士，硕士生导师。现任生命与环境科学学院副院长（分管学院教学、招生、对外交流），并兼化学实验教学示范中心主任（上海市级）。	硕士,硕士生导师	教授
《忍者猎杀队》是一款动作游戏，游戏大小为3.78M。	游戏	游戏
河南省资源综合利用与节能协会是由资源开发、节约、管理、研究、宣传、信息等有关单位和个人组成的全省性专业组织，是不受部门、地区和所有制限制的社会团体，是自愿结成非盈利性社会团体法人。	社会团体,协会	
《窦氏皇后》是由网络写手阒黑编著的一部历史小说，首发潇湘书院网。	小说	小说
《邪魔乱舞》是一本在起点中文网连载的小说，作者是虾壳	小说	小说
《父母送给青春期女孩最好的礼物》一书是由石晓娜编著的青春教育类书籍，由长安出版社于2009年出版发行。孩子可以从该书中详细了解青春期所要面临的问题，身体的变化，生理和心理的变化，帮助孩子，启发家长。	书籍	书籍
雄狮公寓酒店位于阿德莱德，是家4星级酒店。是阿德莱德最受欢迎的酒店之一。凭借独有的人文素养和其婉约美丽的殷殷之情不断吸引着广大顾客的到访。酒店位置较好，距离蒙特菲奥里山步行18分钟，或打车3分钟，车程约1.9公里。	酒店	酒店
湖南选调考试网是湖南公务员考试网旗下网站，网站为广大考生提供最新湖南省选调生考试招考信息、考试试题、政策解读等。第一时发布相关考试公告及大纲，及时为各位考生解决各种相关疑问！	网站	网站
雅居乐集团（AgileGroup），是中国领先市场的房地产发展商之一，雅居乐集团起初1989年是在广东省中山市三乡镇经营一家家俬厂时代家具有限公司。在1992年开始涉足房地产成立中山市雅居乐房地产开发有限公司，于2005年在香港联合交易所主板上市。以房地产开发及经营为主，同时亦广泛涉足物业管理、商用物业及酒店经营等多个领域，集团总部设在香港中环花园道3号花旗银行大厦33楼，下属项目分布于中山、广州、佛山和香港、澳门、海南陵水等省市。	公司	酒店,公司
鉏麑：读音作chúní。鉏麑是晋国著名的大力士。鉏麑在史籍《吕氏春秋·过理》中记作沮麛，在史籍《汉书·古今人表》中记作鉏麛，而汉朝史学家刘向在《说苑·立节》中则又作鉏之弥。	晋国著名的大力士	
M·比斯古博维奇男生于1989年6月30日足球运动员司职后卫	足球运动员	足球运动员司
迪斯康特酒店位于圣彼得堡。是圣彼得堡最热门的酒店之一。也是您来到圣彼得堡商务和休闲的热门之选。酒店，距离埃尔米塔日博物馆/冬宫打车11分钟，车程约5.5公里。	酒店	酒店
《恶少军阀》是踏雪寻梅客所著起点中文网连载的架空历史小说。	小说	小说
贵州林中月酒店位于风景秀丽的贵阳市花溪公园麟山旁，酒店按准五星级标准建造，会议、餐饮、住宿、休闲、度假、娱乐为一体的功能齐全的精品酒店。酒店占地42亩，依山傍水，古树参天，自然绿色，阳光和谐，地理位置十分优越，宜人的气候、齐全的功能和独特优美的环境，使树景、花景、石景、水景，可观至极、可圈可点。实为会议、旅游、度假、休闲娱乐的绝版地带。辅以天赐山水环境形成了山、水、石、树、花、草、的环境中亭、台、楼、阁、书、画的完美搭配。在酒店内形成古朴厚重的“中国元素”让蕴藏的“中国风”布满现代化设施的高品质酒店的各个角落，使每一位来宾都能感受到自然的花溪、自然的林中月。	酒店	酒店
苏州慧菲贸易有限责任公司是一家综合性的贸易公司，公司位于苏州昆山市朝阳路，专.业从事高档母婴产品的研发、设计、销售的专.业公司。	贸易公司	公司
《重生之乱》是一部异界大陆小说，在起点中文网连载中，作者是黄色卡片。	小说	小说
《霸道老公我要定你了》，言情小说，作者刘小玫，连载网站小说阅读网。	小说	小说
郭店村地处荆门西南边陲，紧靠三国古城荆州，207国道、荆沙铁路和襄荆高速公路横贯全境，从长江沙市码头北行16公里即到。郭店村有6个村民小组，农户354户，人口1457人。自2000年以来，郭店村“两委”坚持解放思想,大胆创新，积极带领群众跳出农业生产模式，大力开展招商引资，发展工业经济，走“以工兴村，以工补农，工农共同发展”的新路子，较好地解决了剩余劳动力的就业问题，村级经济逐步发展壮大。全村现有民营企业11家，2007年实现企业总产值7320万元，利税536万多元，就地转移剩余劳动力120多人，全村人均纯年收入达到38000元。	村	店村
《漠之心》是云中书城连载的小说，作者是zole。	小说	小说
《七剑凌天》是寒冬落雁写的网络小说连载于逐浪。	小说	小说
生态哲学就是用生态系统的观点和方法研究人类社会与自然环境之间的相互关系及其普遍规律的科学。对人类社会和自然界的相互作用进行的社会哲学研究的综合。	哲学	
毛昭晰，1929年出生，浙江溪口人，著名史前史学家。现任西泠印社理事、浙江大学文物与博物馆学系教授、浙江省博物馆名誉馆长、浙江省考古学会会长、浙江省历史文化名城保护专家委员会主任、浙江省老教授学会会长、中国自然科学博物馆协会名誉理事长、第七届全国政协委员、第八届浙江省人大常委会副主任、第九届全国人大常委会委员、国际博物馆协会会员、英国图书馆协会会员。	史学家	教授,史前史学家
尤里卡酒店位于迪拜，是家2星级酒店。无论您是因为出差或度假而造访迪拜，尤里卡酒店都会是您住宿的绝佳选择。在这里您将得到一份贴心服务、收获一份美丽心情。酒店位置较好，距离迪拜博物馆打车10分钟，车程约5.5公里。	酒店	酒店
环球教育股份有限公司是一家在美国上市的公司，主营职业培训，股票交易代码：HQGE；公司全面整合中国的著名职教品牌——长沙环球职教集团。公司新任命的董事会主席和CEO何广文先生1994年便创办了长沙环球职业技术学校，是中国职业教育行业的领军人物，他曾荣获国家教育部授予的“全国职业教育先进个人”和国务院授予的“享受政府特殊津贴的专家”等称号。	公司	公司,学校,人物
《步步升仙》是微云疏影所写的玄幻仙侠小说，已完结。本书起点女生网首发。漫漫长生路，陨落者无数。法宝、丹药、功法……世人为求速成，渐失本心，旁门成正途，正道变歧路。不为利动，不被色迷，不随大流，我自坚定本心，纵走歧路又何妨？	小说	小说
北京市进步小学地处西直门交通枢纽，东邻西二环路，北邻北京展览馆和高科技园区，西邻西直门商业中心。位于西直门外南大街，榆树馆胡同一号。学校占地面积8500平方米，建筑面积12000平方米，地上五层，地下两层，带电梯。	学校	学校
溪南镇埭头村位于上岱美村、海岱村、南砂乡和银砂乡片四地中间，国道324线贯穿村中央。全村共辖6个连片、7个分支部、党员214人，总面积约313.7公顷，总人口为6252人，耕地总面积约3000亩。2009年村工农业总产值达到5011.0215万元，人均收入4870元，位居全镇前列。	村	村
《异世梦幻修仙》作者是书线，是在起点中文网连载的玄幻小说。	小说	小说
红燕子鱼属于动物界，鱼纲。主要产地：印度洋。	动物	动物
广东华联建设项目管理咨询有限公司成立于1996年，经过十几年的不懈努力，成长为一家综合性建设咨询企业，先后成立了十多家分公司，是首批通过ISO9001质量管理体系认证的建设咨询企业，具备工程造价咨询甲级、工程监理甲级、工程招标代理甲级、工程咨询甲级资质、政府采购代理机构甲级和工程造价司法鉴定资格。公司现拥有专业技术人员310多名，其中，中高级以上职称的165名，高级工程师32名，广东省专家级人员6名，注册造价工程师、注册监理工程师、注册咨询工程师、一级建造师等共96名。公司先后被评为2010年中国建设工程造价管理协会工程造价咨询先进单位、连续三年被评为广东省诚信示范单位，连续5年被评为“守合同重信用企业”。	公司	公司
《创意策划》是一款Android平台的应用。	策划	
一般而言，发明是应用自然规律解决技术领域中特有问题而提出创新性方案、措施的过程和成果。产品之所以被发明出来是为了满足人们日常生活的需要。发明的成果或是提供前所未有的人工自然物模型，或是提供加工制作的新工艺、新方法。机器设备、仪表装备和各种消费用品以及有关制造工艺、生产流程和检测控制方法的创新和改造，均属于发明。在知识产权领域，发明是指《专利法》所保护的发明创造的其中一种专利类型，是指对产品、方法或其改进所提出的新的技术方案。在专利领域中的发明有其规定的保护对象或者说保护客体。	成果	
精油库是集精油资讯、精油知识、精油词典、精油配方、精油调配、精油用法，精油文化、精油培训等丰富元素为一体的资讯综合性门户网站。	网站	网站
牡丹江火车站，建于1901年，位于中国东北部黑龙江省牡丹江市西安区，隶属哈尔滨铁路局管辖，现为特等站。中国最早兴建的火车站之一。是黑龙江省铁路客运重要枢纽之一。前后方的火车站为在滨绥线上行方向距离哈尔滨站355公里，下行方向距离绥芬河站137公里。距离大连站1380公里。车站性质是区段站和技检站。主要的客运业务有办理旅客乘降；行李、包裹托运。主要的货运业务有办理整车、零担、集装箱货物发到；办理整车货物乘运前保管；不办理爆炸品及一级氧化剂发到。2015年进行站房改造，预计2018年竣工通车，高站台，高架候车厅，有柱雨棚，通车后从牡丹江到北京将从20个小时缩短至5小时30分钟牡丹江到哈尔滨将由原来5小时08分钟缩短至1小时30分钟。	车站,火车站	车站
津市达煜金家政服务有限公司是位于天津市南开区的专业社区服务企业，是经工商局、税务局和劳动局注册的正规天津家政公司	公司	公司
蒋慧卿先生，中国著名书法家、姓氏学家、文化活动家、一级美术师、世界华侨华人姓氏寻根大会主席团筹委会主席、蒋慧卿书法艺术国际巡回展览组委会主席、国际现代书法集编委，周文王之孙周公之子蒋伯龄一百二十二世孙，黄帝后裔。	一级美术师,著名书法家,文化活动家,姓氏学家	美术师,公司
安徽九华山旅游集团公司是九华山风景区国有资产经营主体。注册资本1亿元，主要从事资本运营、旅游服务、旅游商品开发与经营、新旅游项目和新景点开发、旅游信息咨询等相关业务，发展前景十分广阔。集团公司现有九华山金地旅游发展有限公司、九华山旅游发展股份有限公司（辖索道公司、缆车公司、聚龙大酒店、东崖宾馆、青阳西峰山庄、九华山中国旅行社和九华山中国国际旅行社、九华山旅游客运有限公司、九华山游客服务中心、大九华宾馆），九华山风景区票务中心、九华山新区开发建设有限公司、九华山旅游商品开发公司、九华山供排水公司、九华山旅游集团公司秋浦胜境分公司等分子公司。拥有资产达6.8亿元，是池州市旅游龙头骨干企业。	公司	酒店,公司
校长办公室是学校行政管理的综合协调部门，是学校对外的窗口。其主要职能包括：协助校长、副校长处理有关事务；根据校长、副校长要求，督办有关事项；负责起草学校工作规划、计划、决议、领导工作报告等重要文稿；开展有关调查研究，为学校发展提供决策咨询；负责办理全校行政公文；负责协调学校重大活动的举办和重要会议安排；负责校友会、校董会、教育基金会、校法制办日常工作；负责学校统计数据的采集和上报；负责学校印章、校行政领导公用签名章及学校其它重要印证的使用管理；负责群众信访接待工作；处理校领导交办的其它行政事务。	学校	学校
王荣让沾化县政协副主席。沾化县古城镇人。1934年12月出生。1959年7月惠民师范毕业。	沾化县政协副主席	
《麻烦终结者》是由权赫宰执导，薛景求、李廷镇、吴达秀主演的动作电影，于2010年9月9日在韩国上映。该讲述了警察姜太植意外背上杀人嫌疑，必须在24小时内查出事情真相的故事。	电影	电影
赵思达，女，1990年04月24日出生，是一名模特。	模特	
《你我同心》是华语歌手梁铂文演唱的一首单曲。	单曲	单曲
《1944中文版》是一款射击小游戏，支持windows2000以上。	游戏	游戏
CozyChelseaApartment8713位于纽约，是家5星级酒店。纽约理想的下榻之处，您的旅途也将因此而与一份温暖、一份感动不期而遇。酒店位置较好，距离第五大道打车6分钟，车程约3.1公里。	酒店	酒店
《从未敷衍的坚强》是goblins创作的一本爱情婚姻类网络小说。	小说	小说
《第七个没有名字的夏天》是一部连载于看书网的小说，作者是曦悠。	小说	小说
《钱到用时方恨少》是抱泉写的网络小说连载于新浪读书。	小说	小说
安徽华星电缆集团有限公司始建于1986年8月，占地面积72800平方。“华星”拥有先进的技术、精良的设备、全面的质量管理和周到的服务体系，使产品出厂合格率达到100%，客户满意率达到96%以上，早在1998年就顺利通过了iso9000族质量管理体系认证。	公司	公司
武汉市新洲区邾城街中心小学创办于1907年，是一所有着近百年办学历史的市级先进学校。	学校	学校
《城市是个大森林》是连载于起点中文网的一本小说，作者是我亦无言。	小说	小说
平凉澳厦房地产开发有限公司平凉澳厦建筑有限公司被省工商局、平凉市政府授予“重合同守信用企业”，“甘肃省文明企业”、“质量效益A级企业”；被省建筑业联合会评为“优秀建筑企业”，市委市政府授予“精神文明单位”、“综合治理先进单位”，被地区建设处评为“质量安全管理先进企业”，被地区乡镇处评为“先进乡镇企业”。公司党支部书记、名誉董事长、工会主席魏镇玺曾获省、市、县（区）政府及有关部门多次表彰奖励。	公司	公司
左淑丽，女，辽宁省朝阳市中心医院内分泌科主任，主任医师。	主任医师,辽宁省朝阳市中心医院内分泌科主任	主任医师
《离鸪》是晋江文学城连载的一部小说，作者是红摇。	小说	小说
维也纳大学（UniversityofVienna），是奥地利历史最悠久的大学，也是德语区国家最古老的大学之一。始成立于1365年，是27位诺贝尔奖金获得者的母校。维也纳大学目前拥有八个系。她同时也是奥地利最大的大学，欧洲最大的大学之一，在校生八万人之多。大学有80多处校舍，分散在维也纳各区。其中古老、宏伟的主校位于维也纳市一区。维也纳市立医院――这一世界著名的现代化医院也隶属于维也纳大学。	大学	医院
《末世的空城》是连载于晋江文学城的小说，作者是阡陌的阳光。	小说	小说
《黑暗星云HD:第二章DarkNebulaHD-EpisodeTwo》是一款重力感应控制的滚球游戏，游戏的画面非常精致，整体充满了一种浓重的科幻时代的风格。各种各样你见过的或者没见过的科幻类型的事物以及游戏设定，加上到处存在的厚重感十足的金属制品的场景，更凸显了游戏的独特风格。	游戏	游戏
《烟柳妖娆》是在晋江文学城网上连载的一部原创小说，作者是鬓侧桃花。	小说	小说
作者晓昀，架空历史题材连载小说。	小说	小说
杜权成，1972年12月出生，湖北谷城人，毕业于华中师范大学，中学一级教师，系襄樊市骨干教师，谷城县十大教育科研工作者·爱好书画收藏，是中国收藏家协会会员，襄樊市美术家协会会员收集名家字画1500件，被李景上将称为"收藏将军",事迹被中央电视台、《收藏》杂志、《湖北教育》杂志等60多种媒体报道，名载《中国当代集藏家辞典》等20多部典籍，建立有个人书画收藏馆·	美术家,一级教师	美术家,典籍,教师
粤语翻唱歌曲名称：咕啦咕啦超级乐园-唐韦琪	歌曲	歌曲
桂林泰民·金奥文化培训学校创立于2003年，是经市教育局批准，并在市民政局注册的正规培训学校，自成立以来，通过近十年磨练，由英语单科培训，发展为今天的语、数、英、理、化、音乐、艺术、航模，一对一教学从前班到高中的全面、全科的培训中心。2010年被评为“桂林市民办教育机构诚信学校”，桂林市一附，二附，德智学校“小升初”签约培训学校。	学校,教育机构	学校
《宠你的浪漫》是连载于小说阅读网的一部都市言情小说，作者是awen。	小说	小说
聚花野丁香（LeptodermisglomerataHutch.）为龙胆目茜草科植物，灌木，高约60厘米，产于云南东南部和昆明附近。常生于海拔1800-2450米疏林中或山坡上。叶对生，为狭披针形或长圆状披针形，果实线形，包藏于假种皮内。	植物	植物
峰源村是湖南省郴州市桂阳县太和镇下辖行政村，村域位于骑田岭山脉，与南溪乡、大塘乡、鲁塘镇以及芙蓉、当家村相邻。村部设在峰源，离乡政府约15公里，下辖六个村民小组8个自然村庄，村辖下子洞一、下子洞二、坳背、桃树下、六么洞、小南溪。目前有村民136户，538人，占地面积5平方公里。	村庄	村,村部,村庄
《东方英雄传》是连载在起点中文网的一本小说，作者是庙街四斗米。	小说	小说
《俘娈》是连载于晋江文学城的小说，作者是吹莫。	小说	小说
克拉伯纳酒店位于阿尔盖罗，是家4星级酒店。阿尔盖罗理想的下榻之处，您的旅途也将因此而与一份温暖、一份感动不期而遇。酒店。	酒店	酒店
《魂不负你换了个灵魂再来爱》是云中书城发行的小说，作者是纤尘一月。	小说	小说
顾客网—安徽顾网传媒有限公司旗下网站。顾客网提供淘宝、拍拍、有啊等各大电子商务网站的商品发布和信息互动。	网站	网站,公司
浙江长兴人。1963年毕业于宁波师范学院的中文系。历任中学语文教师，长兴县文化馆创作干部，嘉兴地区《南湖》文学期刊主编，中国国际文化交流中心浙江分会《文化交流》杂志编辑，浙江文联《东海》月刊社长、主编。副编审。1972年开始发表作品。1992年加入中国作家协会。	作家	作家,教师
《教父导师》是一部在起点中文网连载的都市生活小说，作者是至诚网络。	小说	小说
安东尼·迈尔斯（AnthonyMyles）1982年10月22日生于伊利诺伊州芝加哥，美国职业篮球运动员，司职前锋，曾效力于CBA联赛东莞新世纪篮球俱乐部、辽宁盼盼篮球俱乐部。	运动员,篮球运动员	美国职业篮球运动员
女皇大酒店位于咸阳市文汇西路与联盟二路交汇处，是一个以盛唐风情为背景，再现唐人、唐韵、唐文化，集餐饮、住宿、娱乐、购物为一体的三星级现代化商务酒店，与“乾陵大酒店”、“裕华宾馆”、“女皇宫假日酒店”同为姊妹店。酒店装饰豪华气派，设施功能齐全，服务质量优良，盛唐气息浓厚，南北大菜美味可口，名优小吃品味无穷，交通便利，安全快捷。	酒店	酒店
戴海宁，男，汉族，1973年6月生，大学，中共党员，德阳市绵竹市供电局局长。	德阳市绵竹市供电局局长	电局局长
期待给的爱是在起点中文网上连载的小说，作者是沙漠白扬	小说	小说
火龙冒险是一款奔跑跳跃的冒险游戏，游戏中你需要操控一只勇猛的小龙穿越十个危险而又独特的卡通世界，冒险过程中，你可以收集不同的魔法，火球和一个强大的护法使者，这些都会增加你的法力，帮助你达到目的。	游戏	游戏
电影《死人之镜》是由英国导演BrianFarnham创作的“剧情、罪案、悬疑”片，又名《大侦探波罗系列/死亡约会》，于1993-02-28上映。	电影	
《乘隙》是沈括所写的一篇文言文。该文言文告诉我们事情总是在不断发展变化中，如果总是沿袭老一套，那么肯定会反受其害的。	文言文	
《宇宙的温暖的地方》作者是酷吻，是在起点文学网连载的都市言情小说。	小说	小说
《落跑前妻回头爱》是秋云兮写的网络小说连载于晋江文学城。	小说	小说
玛丽娜·查普曼，是英国约克郡布拉德福特家庭主妇。她幼时曾被绑匪丢弃在南美洲哥伦比亚的丛林中，被那里的卷尾猴养大。在15岁左右，她成为一个哥伦比亚家庭的佣人。20多岁时，雇主因工作需要带她前往布拉德福特，后来她在这里结识了约翰·查普曼，两人迅速坠入爱河，并在几个月后喜结连理，随后生下两个女儿。她亲笔撰写的回忆录《无名女孩》从2013年3月30日开始在《星期日邮报》上连载。	家庭主妇	
第二使徒，《EVA》中的出场人物。在《EVA》中的莉莉斯，是被钉在NERV总部地下，最终教条十字架上的白色巨人。第二使徒是莉莉斯，最早出现于苏美尔神话，亦同时记载于犹太教的拉比文学。	人物	人物
由木城镇和平街委于1997年创办，投资1500万元。是融小学、初中于一体的全日制初等教育学校。	学校	学校
《我们发生的一切》是连载于起点中文网的小说，作者是薄荷香妮。	小说	小说
《画圆》是起点中文网连载的小说，作者是一笑情。	小说	小说
涉县职教中心坐落在涉县县城之南的清漳河畔，距八路军""一二九师""司令部旧址仅三公里，是教育部认定的首批国家级重点职业高中，有""冀南明珠""之称。学校起步于上世纪八十年代，经历了从无到有，从小到大，历经艰辛坎坷的发展之路，已壮大为融普通中专、职业中专、职业高中、短期培训为一体，技能培养、劳务输出和学历教育相结合一所国家级重点中等职业学校。07年首批荣获""全国职业教育德育工作实验基地""荣誉称号，是全国职业教育先进单位。学校坚持""以服务为宗旨，以就业为导向，以技能为本位，以提高教育教学质量为重点""的办学指导思想，深化改革，规范管理，开拓创新，取得了明显的办学效益。	学校	学校
《脂染落霞》是在17k小说网连载的小说，作者是若墨。	小说	小说
《反暴特战队》是2000年太平洋影视有限公司出版发行的一部动作电影，唐纳佛斯特、佛雷威廉森主演。《反暴特战队》讲述了在南斯拉夫战火不断蔓延下，美国政府对是否要出兵相助的问题犹豫不绝。塞维族的恐怖份子暗中进行一项颠覆华府和联合国的阴谋，联合国派遣马龙上校身入敌方从事破坏，他是否会成功呢？	电影,动作电影	公司,电影
铁岗社区居民委员会由原铁岗村民委员会于2004年4月30日改建，位于共和镇区东南部，相距1公里。	社区	
中国人民解放军第455医院是一所具有70多年历史，集医疗、教学、科研为一体的大型综合性三等甲A驻军医院·目前医院拥有国际一流的核磁共振诊断仪、高速螺旋CT、数字减影血管造影系统、彩色多普勒超声诊断仪、全自动生化分析仪、多功能心血管监护系统、立体定向伽玛射线全身治疗系统、体外循环机等一系列先进医疗设备。	医院	医院
包凤英，女，1953年12月出生，工程师。1973年9月，在山东化工学院橡胶系读书。毕业后在青岛橡胶工业研究所工作。	工程师	工程师
《偷星九月天之邪》是在飞卢小说网上连载的同人小说类型的小说，作者是邪杀破狼。	小说	小说
黄斌，男，汉族，南山区总工会副主席。	副主席,南山区总工会副主席	
《法律谈判之道》是法律出版社出版的一本书籍，本书涉及谈判的法律技能，这一技能对于律师而言是必备的。在英国，绝大多数的诉讼请求都是在审前解决的。	书籍	书籍
姚增强，中国内地男演员。1972年12月出生在河北沧州，1991年应征入伍，在新兵连的时候就一举获得了全师歌手大奖赛的冠军。代表作品有《勇敢的心》《将军》《苍狼》《三八线》等。	演员	演员
《在我左后方的你》是连载于红袖添香网的小说，作者是NLC。	小说	小说
《海贼王之青空》是连载于起点中文网的一部小说，作者是七夕小猪。	小说	小说
《失落之墓》是连载于17k小说网的盗墓探险小说，作者是竹叶的心。	小说	小说
鱼仔灯是一种民俗习惯。	民俗	
《异世之灵神》是连载于起点中文网的玄幻小说，作者是我爱吃叉烧，	小说	小说
上海秀发千姿网络科技有限公司创立于2009年，总部设于上海。作为领先的网络科技电子商务企业，秀发千姿网络科技有限公司将通过秀发千姿B2B电子商务行业网、秀发千姿B2C商城为广大发饰品企业提供最周到、最丰富的发饰品行业服务。	公司	公司
湖南省蝴蝶树摄影化妆艺术学校是经湖南省劳动厅和省民政厅批准、由蝴蝶树婚纱艺术集团投资创办，以摄影、化妆、数码、销售管理等影楼人才培训教育为主的全日制学校，也是省内最先开设影楼摄影、化妆、数码美工、销售管理系统化教育的学校。	学校	学校
维内托是1988-06-14出生的足球运动员。	运动员	足球运动员
《找个说理的地方》是连载于小说阅读网的网络小说，作者是作家王子月。	小说	小说
《带着系统好修仙》是一本连载在起点中文网的小说，作者是休虚。	小说	小说
廖林昆（1993年1月1日－），是一名中国足球运动员，现在由贵州人和租借到中国足球乙级联赛的陕西老城根足球俱乐部，司职中场。	运动员,足球运动员,中国足球运动员	足球运动员
《钥匙村和锁村(寓言故事)》是一部充溢着幽默哲思，跳跃着童真稚趣的金典寓言。全书共分物体之悟、动物之悟、植物之悟、世态之悟、诗情之悟、舞台之悟、学思之悟七辑，每个篇章中，人物不同，视角各异。精巧引人的故事，浪漫机智的诗歌，跌宕起伏的剧作，谈古论今的述评，构成了一个个妙趣横生的寓言方阵。我国著名寓言作家白水平奉献给广大读者的是一串串智慧的珍珠，阅读时让人眼前一亮，掩卷后有更多的回味。	幽默哲思	诗歌,动物,植物,人物
淇县工商行政管理局是淇县政府机构，位于河南省鹤壁市淇河路62号，主要职责是负责市场监督管理和行政执法。	政府机构	政府机构
轰炸机战争修改版是一款射击小游戏，9807K(游戏大小)	游戏	游戏
北冕座α是一个联星系统，相似于英仙座β（βPer或大陵五）。其周期为17.36天，视星等为+2.21至+2.32，单靠肉眼难以看到。	联星系统	
王菁华，女，汉族，1965年1月出生，安徽宿州人，宁波工程学院副院长。	院长,副院长	宁波工程学院副院长
高鑫，河北高阳人。现任北京电视艺术家协会副主席。	副主席	电视艺术家协会副主席
《我只是爱上你》是连载于晋江文学城的小说，作者是沈如简。	小说	小说
洪都小学创办于1952年，有着60年悠久的办学历史，积累了厚重的校园文化。以创建“平安校园、书香校园、生态校园、数字校园、文明校园、人文校园”为办学思路，强化“规模大校、质量优校、实力强校、环境美校、素质好校、品牌名校”办学特色，以“师生为本、德育先行、技艺并重、智慧至上”为办学理念，在学生发展上“给孩子一座天空之城”；秉承“励志蓝天上求学大地中”的兴学校训，根据学校规模大的特点，开辟了“大年级小学校”这一新型管理模式。	学校	学校
漫画《海贼王》里一个国家，最早提到是在第584话尾页。原作介绍：一尘不染，被誉为东海最美丽的国家；将不必要的事物完美排除的这个国家，称得上是‘隔离社会’成功的典范。风车村，非确定物终点站，戈尔伯山均为此国领土。天龙人曾来访此国。※哥雅也有三角形的意思，这里取音译；右图方框中的文字可以忽略	漫画	
五膜草科（Pentaphragmataceae）又名五隔草科，只有1属约30种，主要分布在东南亚。中国有3种，全部生长在南岭以南地区。本科植物为多年生草本；茎短；单叶互生，叶大，稍肉质；花两性，小，排成蝎尾状的穗状花序；花冠钟状，白色，5裂；果实为浆果，有多个小种子，种皮有网纹。	植物	植物
北京京瑞日机电设备有限公司（简称“北京京瑞日”），位于文明之都--北京。是一家销售进口轴承的公司。主要产品有：SKF、FAG、NSK、Timken等进口轴承。公司目前现下有员工50多人，年销售额近1000万元。公司的产品在消费者当中享有较高的信誉，与多家代理商、零售商及企业建立了长期稳定的合作关系。本公司实力雄厚、重信用、守合同、保证产品质量，以品种齐全、价格合理和薄利多销经营特色的原则，赢得了广大客户的信任。公司一贯坚持“质量第一、用户至上、优质服务、信守合同、专业、专一”的宗旨，凭着高质量的产品，良好的信誉，优质的服务，产品畅销全国近三十多个省、市、自治区。竭诚与国内外商家双赢合作，共同发展，共创辉煌！	公司	公司
读者影视动画培训学院隶属于读者集团甘肃读者动漫科技有限公司，是经甘肃省人力资源和劳动保障厅批准，甘肃首家唯一官方授权的影视动画人才和IT技术人才培养教育中心，也是省内第一家引进幸星国际动画项目实训体系的动漫教育领军学校，拥有国际师资队伍和国内先进而成熟的动漫人才培训课程体系，以及丰富的实训项目和高端、舒适、顶级的教学环境。学院以高校为依托，以市场就业为导向，以高水平技术精英为支柱，以学员学有所成为理念，传授给学员专业技能的同时，着重培养学员的艺术修养和文化积淀，使每一位学员能够站在人生高度上审视流光溢彩的大千世界，成就个人艺术梦想。	学校	公司,学校
《惊神传说》是连载于起点中文网的小说，作者是不懂浪漫的青蛙。	小说	小说
刘锋，男，汉族，1963年12月出生，江西省安义县人，1981年7月参加工作，江西省宜春师范普师专业毕业，大学本科学历，1983年11月加入中国共产党，现任中共奉新县委常委、县人民政府副县长。	副县长	副县长
酒糟五彩汤圆是一道甜点，糯米是一种温和的滋补品，有补虚、补血、健脾暖胃、止汗等作用。	甜点	
李金泰别署老泰；笔名赤峰。书法家、诗人、学者、书法理论家。致力于楚简书法的传承和创新。师从著名书法家刘艺先生。现为中国书法家协会会员，中国楚简书法研究院院长，中国诗词学会会员，中国楹联协会会员、艺委会委员。	学者,书法家,诗人,书法理论家	书法理论家,书法家
多悦高中（原眉山县第二中学），位于东坡区多悦镇，是东坡区农村高中中较好的一所，历年高考成绩名列全区第四，学校离眉山市区17公里，目前学校占地面积约70亩，在校学生人数达两千多人，教学班约25个，学校绿化面积占学校总面积的60%以上，有香樟园和四季桂，到春天的时候四处飘香，景色宜人。被誉为“花园式学校”。	学校	学校
贝斯特韦斯特阿穆拜尔酒店位于CifteGelinlerCad.No:3Kumkapi,法提赫,34126伊斯坦布尔。	酒店	酒店
BrunelloCucinelli来自意大利的世界顶级奢侈品牌，被誉为低调奢华的“山羊绒之王”和“服装界真正的奢侈品”。很多人都知道羊绒Cashmere顶级、昂贵，一穿就脱不下来，还很容易和其他衣服相互搭配，但是，再也没有比BrunelloCucinelli这个品牌更懂得把顶级的羊绒面料设计出一种“低调的奢华”的风格。	品牌	品牌
周应萍，兰州理工大学副教授,1989年参加工作，毕业于天津大学，工作以来一直从事化学工程与工艺专业的教学及科研工作。	教授	教授
云恩斯古特是一名比利时籍足球运动员，球场位置是中场。	运动员,足球运动员	足球运动员
《离殇清唱永夜未央》是竹耳写的网络小说连载于起点中文网。	小说	小说
《唐朝世家子》是一部小说，作者是唐朝游侠儿。	小说	小说
《80年代的忏悔》是一本在红袖添香网连载的小说，作者是懒人--牵牛	小说	小说
《神龙少年》是一首动漫歌曲作品，同时也是一部连载小说名。	动漫歌曲作品	小说,歌曲作品
小海豹冲冲冲是一款探险游戏	游戏	
25号州际公路（Interstate25，简称I-25）是美国州际公路系统的一部份。北起怀俄明州布法罗（与90号州际公路交汇），南在新墨西哥州拉斯克鲁塞斯与10号州际公路交汇。	公路	游戏
职业棒球2011安卓版是一款体育竞技类游戏，发布时间为2012.03.08。	游戏	游戏
《混在汴梁》是连载于天涯读书的一部言情类小说，作者是火山_灰。	小说	小说
田口壮是一名职业棒球手，曾任美国职棒大联盟的圣路易红雀队的球员，守备位置为外野手及内野手。他出身于日本兵库县西宫市，已婚，育有一名儿子。	职业棒球手	
杰米·杜菲是一名美国籍足球运动员，球场位置是中场。	足球运动员	足球运动员
大卫麦科隆，出生于1983年2月8日，苏格兰人，足球运动员。	足球运动员	足球运动员
今华光学由台湾两大知名上市公司今国光学和华晶科技投资，总投资8000万美金。今国光学是台湾“光学三雄”之一，为光学镜头专业制造厂，拥有从设计、开发、原料、生产的作业制作群，生产高精密产品，照相机伸缩镜头、数码相机伸缩镜头、扫描仪等；华晶科技则是台湾数码相机出货量冠军企业，是台湾最早投入、开发量产百万画素以上专业数字相机之研发制造的公司，也是台湾唯一自有核心系统控制芯片的数字相机厂。	公司	公司
《盘古开天》是一部在2013年拍摄的国产动画片。	动画,动画片,国产动画片	动画片
成都多戈服饰有限公司成立于2000年，是一家崇尚简约、个性风，集休闲时尚、都市商旅为一体，追求自由挥洒的生活空间及积极的社会责任。	公司	公司
汕头粤成动游网络科技有限公司是一家集安防监控产品研发、生产、销售为一体的技术企业，现有员工400多人，厂房面积10000多平方米，有6条生产线，3条SMT自动化流水线。	公司,技术企业	公司
公司依靠坚实的业务知识，丰富的实践经验，诚信的职业品质，稳健的业务作风，为企业的成长、节税与避险提供最佳的财务保障。	公司	公司
《魂破虚空》是连载于看书网的一部小说，作者是寂寞无伤。	小说	小说
网络作家张军建，笔名素食主义，代表作品《窃密者》管理咨询师张军建：潜能激发，团队训练，中层执行，HR项目咨询、企业标准化管理中南大学法学院教授张军建	作家,网络作家	
地面防滑剂是一种带清洁作用的化学处理剂，使用后能够在地板表面被弄湿时有效增加摩擦系数，防止滑倒，从而杜绝因湿滑产生的事故及引起的身体伤害。（使用产品后的地面符合国际统一安全标准，即湿地状态地面摩擦系数在0.5及以上）	化学处理剂	
《缘来一梦中》是在幻剑书盟连载的一部机甲时代小说，作者是晓梦依依。	小说	小说
古斯蒂卡勒楼酒店位于巴厘岛。巴厘岛理想的下榻之处，您的旅途也将因此而与一份温暖、一份感动不期而遇。酒店位置较好，距离乌布步行4分钟。	酒店	酒店
斯堪特罗姆瑟酒店位于特罗姆瑟。	酒店	酒店
《似花非花》是连载于云中书城额推理悬疑类网络小说，作者是青菊。	小说	小说
《纳岚之雪奈若情劫》是磬馨幽竹写的网络小说连载于起点中文网。	小说	小说
《复彭丽生书》是曾国藩的一篇散文	散文	
《妖颜魅，蛇女的亲亲夫君》是一部言情小说	小说	
知命，汉语词汇。拼音：zhīmìng释义：(1).谓懂得事物生灭变化都由天命决定的道理。(2).代称五十岁（多指已经看透命运的走势和明白命运的意义）	汉语词汇,词汇	小说,词汇
《神手之死》是红袖添香网连载的小说，作者是leotan。	小说	小说
陈红，女，1968年12月30日出生于黑龙江省哈尔滨市，从北国冰城哈尔滨到中国流行音乐中心的北京,从第三届全国青年歌手电视大赛的"荧屏奖"到第五届大赛的亚军，再到今天被人们所熟悉喜爱。现任海军政治部文工团国家一级演员，海军政治部电视艺术中心副主任，正师级海军大校，香港佛教文化产业--佛教音乐委员会委员，2011年度十大海洋人物，中国红十字会博爱大使，海洋公益形象大使，北京旅游形象大使。连续多年参加中央电视台春节联欢晚会。	歌手	演员,人物
臧晓玉，影视女演员，2014年主演电影《浮云》入围北京国际电影节。2002年进修于北京电影学院，电视剧《还是好日子》饰女儿号蓝水水，《清宫秘史之一帘幽梦》饰月影，《讨债》饰女一号小丽，《国球之子》饰阿丽等影视剧。	影视女演员	演员
杨华，男，湖北钟祥人。复旦大学历史系，学士、硕士（中国古代史）、博士（先秦史）。武汉大学历史学院、中国传统文化研究中心、简帛研究中心教授，博士生导师，兼任武汉大学历史学院副院长、中国传统文化研究中心副主任。美国伊利诺伊大学亚太研究中心，访问学者，德国特里尔大学汉学系，客座教授。	教授	教授
胡远扬，男，武汉大学生命科学学院教授，博士生导师。	教授	博士生导师,教授
北京宏绣国际投资有限公司是一家创立于2008年的民营股份制企业，总部设在北京，其前身是建于1996年的宏深华美公司。公司的主要投资方向为刺绣艺术及文化创意产业。	公司,民营股份制企业	公司
电影《艺术家的生活》讲述的是一个想要当歌手的女生，遭遇了很难产的邻居，歌手之路也不是一帆风顺，勉强在餐馆打工也搞得一团糟，最后竟然只能穿着滑稽的外套当吉祥物一个想要有正式的舞台作品的女演员，一直在为动画片配音，跟经纪公司争取也只能收到别的演员又有戏上的消息，让自己更加失落，而配音时合作的男人是个自恋的话痨，好友却是舞台上的焦点一个想当作家的中学老师，跟同校的数学老师同居中，两个人的关系总是被学生嘲笑，而他自己的作品也被人嫌	电影	演员,公司
金乡县通达机械有限公司位于山东省济宁市金乡县，金乡县通达机械有限公司是一家铸造及机加工对外承接各种铸造与加工业务。	公司	公司
青岛安泰重工机械有限公司成立于2003年4月，位于交通便捷、风景秀丽的胶南市，是一家以先进技术为核心，以信息技术为手段，以机械设备为载体，集科研、设计、制造为一体，为企业提供安装调试与咨询服务的现代化大型机械装备制造企业。	公司	公司
聚财，中国民俗之一。俗传正月初一（拜年/占岁/聚财）同时也是扫帚生日，这一天不能动用扫帚，否则会扫走运气、破财，而把“扫帚星”引来，招致霉运。假使非要扫地不可，须从外头扫到里边。这一天也不能往外泼水倒垃圾，怕因此破财。今天许多地方还保留着这一习俗，大年夜扫除干净，年初一不出扫帚，不倒垃圾，备一大桶，以盛废水，当日不外泼。	民俗	
四条隆资是为后醍醐天皇讨伐北条氏，实现中兴的计划尽心竭力，南北朝分裂后与北畠亲房并列，辅佐后醍醐，后村上两代天皇的忠心耿耿的人物。	人物	人物
《盛夏上演的宫之恋》是一部连载于幻剑书盟网的都市生活小说，作者是美琳塔。	小说	小说
《吞噬七界》是连载于起点中文网的异世争霸类小说，作者是顺晟。	小说	小说
马科斯·安东尼奥·埃利亚斯·桑托斯是一个出生于1983-05-25的巴西足球运动员，所属球队是纽伦堡足球俱乐部。	运动员,足球运动员	足球运动员
波兰瓦乌奇国立高等职业学校是一所通过中国教育部认证的成立于2004年的年轻高校。该校积极参与国际交流与合作，目前该校已经加入欧盟框架内的苏格拉底-伊拉斯谟交换生计划，现在已经与法国巴黎第十三大学签订了双边协议，互换学生交流学习。	学校,职业学校,年轻高校	学校
《妖界风云》是连载在起点中文网上的一部仙侠异侠小说，作者是金木水水火土。	小说	小说
基里利丘克--1956年出生于俄罗斯奥尔斯克城。1982年毕业于萨拉托夫州艺术学院。俄罗斯功勋艺术家。	艺术家	功勋艺术家
《黯耀》是一部连载于起点中文网的东方玄幻类小说，作者是孤十日。	小说	小说
东方宝螺是中腹足目、宝螺科的一种生物，螺壳尺寸为56mm。分布于澳洲西部和南部。	生物	生物
“优朗教育”系重庆优朗教育科技有限公司旗下教育品牌，业务涵盖，继续教育\职业培训等相关业务，重点从事学历教育自考，网络教育，成教，电大国民教育体系学历获取咨询服务，全面专注于学员发展的完整性和必要性服务之中，让您插上翅膀，飞的更高走的更远。	公司	公司
重庆海联精细化工有限公司始建于1992年，是国内较早的涂料生产厂家之一，生产品种有氨基系列、丙烯酸系列、硝基系列、过氯乙烯系列等专用漆。广泛应用于汽摩、家具、鞋业等行业。	公司	公司
温州雨润机械科技有限公司坐落在东海之滨、瓯江口南岸的温州经济技术开发区滨海园区，地理位置优越，交通便捷。所在地是浙江南部唯一的国家级开发区，于1992年3月16日经国务院批准设立。公司主要生产制造制药、食品、化工、生物等行业所需的成套设备，包括提取浓缩设备、废水处理设备、防腐设备、配制贮存设备、精馏萃取设备、干燥混合设备及管道配件等。公司拥有一批高素质的设计制造工程技术人员和生产安装骨干，是一家集科研开发、生产、销售、安装售后于一体科技型企业	公司	公司
吴静，1961年生，河北怀安人，医学博士，研究员，硕士生导师。为学科点的发展以及学校重点实验室的建设做出一定的贡献，具体体现在：眼科学研究室在2005年被授予国务院侨办重点学科、2007年被评为广东省重点学科。	研究员	学校,研究员
佛山市易聚联盟电子商务有限公司成立于2012年9月17日，是香港ECG（集团）在大陆的合作伙伴，是一家集“网站开发、维护、商品批发、零售等于一体的电子商务科技企业，是国内标准化营销网站的先行者，致力于创造一个从产品挑选到销售过程都标准化、规范化的网络营销平台，公司位于广东佛山市顺德区。	公司	公司
围棋角色扮演游戏，是一种将围棋和角色扮演游戏元素相结合的新型游戏类型，在游戏中，玩家负责扮演一个角色在虚拟的世界中活动，以围棋为载体，在一个结构化的规则下通过运用围棋知识与实施一些行动令所扮演角色发展，在遵循角色扮演游戏系统规则的同时突出围棋的主题。	游戏	游戏
杭州学敏家具有限公司坐落于杭州市，公司创建于2009年初，主营学敏学习桌；学敏电脑桌；学敏学习椅	公司	公司
《黑道女生勿碰偶》是一部在17k小说网连载的青春校园类小说，作者是蛋筒。	小说	小说
《我的老婆是检察官》是连载于云中书城的一本都市类小说，作者是道泉。	小说	小说
刘翠萍：1984年毕业于河北医科大学医学系。硕士学位，副主任医师，副教授，儿科副主任。	教授,副教授,医师,副主任医师	副教授,副主任医师
李赞忠，男，中国民主同盟盟员，科技处副处长，教授，高级工程师。1983.9～1987.7在兰州大学化学系有机化学专业学习。1987.8～1995.8在内蒙古粮油食品科学研究所工作，任工程师。先后承担了内蒙古自治区粮油食品的质量检查和营养成分分析检验工作；承担了地方特色食品的研发工作；承担了全区粮油食品质检人员的培训教学工作。	教授,科技处副处长	教授,高级工程师,工程师
《墨香江湖》是在小说阅读网连载的传统武侠小说，作者是清芷影。	小说	小说
广州市白云区竹料镇第四小学（竹料四小）环境优美，绿树成荫，设备设施按区一级学校得标准配置，具有浓郁得校园文化氛围和特色。	学校	学校
痹痛酊是一种药品，用于急、慢性风湿性关节炎。	药品	药品
台湾岩芋（学名：Remusatiaformosana）是天南星科岩芋属的植物。分布在台湾等地，生长于海拔1,450米至2,800米的地区，目前尚未由人工引种栽培。	植物	植物
泥宝是一种天应石浆，产自湘西边陲滩头古镇。滩头是全国有名的七十二古镇之一，有上千年的历史。在古镇绵延的竹林中，静静地孕育着大量的竖式夹层结构花岗岩，细小的夹缝中，藏有薄薄一层泥块，这就是神秘的泥宝！	石浆	
《穿越之冷俊太子调皮妃》是连载于小说阅读网的小说，作者是残留夕阳美。	小说	小说
《绝色王妃哪里逃》，作者紫魅，是云中书城连载小说。	小说	小说
界天星图是一本异界修真小说，讲述少年崛起的点点滴滴，发表于2015年	小说	小说
厦门凌氏生物科技有限公司成立于2010年，以弘扬中华两千年中医文化为己任，致力打造民族自主去屑品牌，创造平衡、和谐的健康人生。并在2010年12月20日，正式签署中央电视频道CCTV.com，成为“美容美发用品·黄金展位合作伙伴”。公司坐落在美丽的鹭岛城市-厦门，主打产品填补了国内去屑止痒的空白。	公司	公司
阎文奎，男，现年77岁（推测的），前电子科技大学教授，1955年毕业于北京政法学院。	前电子科技大学教授	教授
《奈何殿下太撩人》是在红袖添香网连载的言情小说，作者是飞雪流觞。	小说	小说
《一梦过几年》是由陈沫编写的青春校园类小说，于17k小说网连载。	小说	小说
《故宫惊魂》磨铁中文网原创悬疑小说。已完结。作者：山海天。	小说	小说
《浮生两世劫》是晋江文学城连载的言情小说，作者是狐步嘘声。	小说	小说
《一剑解恩仇》是一部连载于起点中文网的武侠小说，作者是南宫绝尘。	小说	小说
《穿越之女扮男装做捕头》是连载在红袖添香网的小说，作者是木拓明珠。	小说	小说
阳泉市桃南路小学创办于1973年，原名机厂小学，2005年12月归入矿区政府，2006年1月学校更名为桃南路小学。伴随现代教育的铿锵节拍，桃南路小学锐意改革、与时俱进，在素质教育的大路上留下了一串串坚实的脚印。学校现总占地面积为6987.39平米，拥有1幢教学大楼、1幢综合楼、1块150米跑道的场地、1块篮球场。学校还拥有2套多媒体教学设备，1个微机房、1个实验室以及音乐室、劳技室、美术室、体育活动室、图书室、阅览室等专用教室。组建了完整的校园内部局域网，实现了教育教学资源的共享。学校现有10个教学班，在校生304人，教职员工43人。学校以“崇德立身”为校训，使教师真正领会“学高为师，身正为范”的真谛，使学生真正学会探索，学会做人，学会创新，学会共处，从而鼓舞他们奋发进取，享受成功的喜悦。	学校	学校
深圳市爱摩登通讯技术有限公司成立于2005年，是一家集移动通信终端产品的研发、设计、生产、销售及售后服务为一体的高科技企业。公司成立以来，本着“设计引导消费，创新实现价值”的产品研发理念，以消费者需求为导向，关注消费者的体验和感受，通过不断创新，为消费者提供高科技、高品质和高品位的手机产品。有能力进行从手机芯片开始的全过程开发，包括手机的外观、结构、主板硬件设计和软件开发、全部生产支持。至今已经成功研发并投产了几十款手机，覆盖高、中、低端和商务、娱乐、经济实用等全线产品。	手机	公司
《血之郁金香》是一部连载于新浪读书网的综合其它小说，作者是scorpio。	小说	小说
个人简历：1940年7月28日出生于长春市1958?7—1961?8：在长春十一中学读高中1961?9—1966?7：在吉林大学法律系学习1966?7—现在：在吉林大学法学院任教82年10月评聘为讲师。90年10月评聘为副教授。	教授	副教授
南通那芙尔服饰有限公司成立于2001年5月。公司坐落于江苏省南通市海安县经济技术开发区东湖路1号丝绸工业园，	公司	公司
《林夕非梦》是连载于晋江文学城原创类小说，作者是心束负。	小说	小说
芜湖市雨田农业科技有限公司是以经营有机农业、特色苗木花卉研发、种植和销售，园林、市政建设、餐饮服务为范围的综合性民营有限公司。公司成立于2009年4月，注册资本2008万元，公司总部位于安徽省南陵县许镇镇内，投资建设的雨田科技园占地面积近2000亩，其中：有机农业种植400亩，特色苗木培育和种植1200亩，畜牧养殖200亩，房屋建筑及景观广场面积150亩。公司现有高级管理及技术人员120余人，企业员工400余人，拥有经验丰富的专业技术队伍，先进的研发技术，配套的种植基地，星级餐饮酒店，特色的农业观光景点和科学的管理方式及完善质量保证体系，并和多家院校、研究院（所）合作研发有机农业、特色苗木的培育、种植和销售。公司其它产业运行稳定，正在向集团化发展。	公司	酒店,公司
维也纳国际酒店（广州火车南站店）座落于广州市番禺区钟村牌坊旁，毗邻105国道、长隆野生动物园、祈福新村和莲花山等，距广州火车南站仅5分钟车程，距广州琶洲会展中心馆仅20分钟车程，地理位置优越，交通方便。酒店周边汇聚大夫山森林公园和余荫山房、宝墨园等名胜景点。紧邻吉盛伟邦、万博中心、迎宾豪泰星级酒店用品市场、沙溪五金塑料城、雄峰商城等专业市场。酒店由国际知名设计师专业设计，设有舒适宽敞的客房与套房，提供餐饮、会议室、棋牌室、沐足中心、商务中心、车辆租赁、甲级写字楼出租等配套服务及设施，是集客房、餐饮、娱乐、休闲、会议于一体的精品商务型酒店。	酒店	酒店
斯尔迪安·拉基奇是一名克罗地亚籍足球运动员，场上位置是前锋。	运动员	足球运动员
火遮眼是2000年10月19日上映的一部香港电影，由蓝志伟ChiWaiLaam导演。	电影	电影
孙世新，男，1960年生，汉族，辽宁鞍山人。学画四十年，工写意，精工笔，师从著名书画家王廷风、于庆霁等先生，临古不辍，心灵手巧，笔墨技法纯熟，为当代不可多得的国画家	书画家	
宝缦家纺始建于1997年，前身为南通宏润卧室用品有限公司，2001年更名为江苏宝缦卧室用品有限公司，是国内最早涉足家用纺织品行业并发展成优势品牌的大型家纺企业之一。经过10年的风雨磨砺，今天的宝缦家纺已发展成为集研发、设计、生产、销售于一体，以“技术触动灵感生活”为核心灵魂，致力于成就品味前瞻的时尚卧室用品的知名企业。产品分为豪华套件、欧式套件、单件组合系列、卡通系列、夏令用品系列、被子系列、枕芯系列、毛浴巾系列、保健系列、窗帘系列、靠垫、餐橱、床垫系列总共十三大系列400多个品种。公司厂区占地面积两万多平方米，拥有各类先进生产技术设备。且具有雄厚的经济实力，年产量达到1.5个亿，并通过了ISO9001、2000质量管理体系认证。公司瞄准国内市场，短短两年内在全国九十几个大中城市设立了特许加盟点，同时产品远销美国、日本、中东、台湾等世界发达国家和地区。公司注重企业文化建设，采用现代先进的管理模式，全面导入CIS企业形象识别系统。建立了科学、明晰的组织架构，广纳贤才，稳健经营。宝缦现已被评为"AAA"最高资信企业、"消费者信得过企业"、"重合同、守信用"企业等。在保证质量的同时，追求格调与时尚相结合，并且不断提高产品附加值，使产品始终处于行业领先水平，成为众多客户的首选。	公司	公司
1988年1月28日出生于河南周口，中国大陆导演，汉族，2009年毕业于四川音乐学院歌剧专业，毕业后为了梦想一个人漂泊在北京，在感受到在外的艰辛2011年初过年回家之际带领兄弟一天时间拍摄了十分钟短片《衣锦还乡》引起各大媒体纷纷报道，2011年底北京电影学院进修，2012年初拍摄短片《家的感觉》感动无数漂泊青年落泪，2013年初执导南国红豆影视投资拍摄的文艺片《蓝风衣》。2015执导电影《我的青春你来过》	导演	歌剧专业
《风吹过的校园》是红袖添香网发行的小说，作者是mingren289。	小说	小说
侯宗，男，1963年4月26日出生。工程师，任职于中原石油勘探局采油一厂。	工程师	工程师
北京完美建信影视文化有限公司是由郭靖宇导演于2011年3月创办的集影视投资、拍摄、制作、艺人经纪为一体的知名影视公司。公司自成立以来，投资并拍摄了电视剧《红娘子》、《火蓝刀锋》、《打狗棍》，并和视频网站爱奇艺合作，拍摄制作了网络剧《灵魂摆渡》。公司出品的电视剧，在各大卫视台、中央台多轮播出，不仅创下了高收视、好口碑，还让剧中演员在影视界声名鹊起。完美建信影视于2013年伊始正式成立了艺人经纪部，与老中青三代实力偶像明星建立了长期合作关系，目前公司签约的知名艺人已有20名。完美建信艺人经纪部是由演艺界资深策划、经纪人、宣传主导运营，拥有一支专业而富有激情的工作团队，业务范围涵盖艺人经纪、影视策划、演出策划、娱乐营销等多个方面。展望未来，完美建信影视希望通过专业化的管理，雄厚的资金实力，以及实事求是、踏实稳健的作风，与国内外诸多影视企业一道，为中国影视行业的蓬勃发展贡献出自己的一份力量。	公司	公司,电视剧
《夕阳下的爱情馀辉》是在红袖添香网连载的一部言情小说，作者是沐颖。	小说	小说
《命运旋转之轮》是一部小说，作者是夏夜蔷薇，连载网站红袖添香网	小说	小说
《落影录》是连载于晋江文学城的小说，作者是纳兰落月。	小说	小说
《阴差没有错》是在晋江文学城连载的一部小说，作者是小说鬼	小说	小说
凯莱洛·费申科（1986年12月24日—）出生于苏联乌克兰第聂伯罗彼得罗夫斯克州（Dnipropetrovsk,UkrainianSSR,SovietUnion），乌克兰职业篮球运动员，司职中锋，效力于NBA犹他爵士队。	运动员,篮球运动员	运动员
吕雯2012年专辑，专辑中有很多歌曲被选为《真爱惹麻烦》插曲，EQ唱片公司出版发行。	专辑	公司
莆田市康民白蚁防治有限公司是莆田地区专业从事白蚁防治的专业机构之一，是由莆田市住房和城乡建设局审批并直接管理的专业白蚁防治机构。	公司	公司
姚淑英，女，中国中医科学院针灸研究所副主任医师，皮肤科负责人。	中国中医科学院针灸研究所副主任医师	副主任医师
《异能界传》是一部小说，作者流年之际。	小说	小说
《穿越之失忆宫主》是连载于看书网的架空历史类小说，作者是米虫小九。	小说	小说
戈伍姆赫尔酒店位于德累斯顿。是德累斯顿最受欢迎的酒店之一。凭借独有的人文素养和其婉约美丽的殷殷之情不断吸引着广大顾客的到访。酒店。	酒店	酒店
好奇酒店位于巴塞罗那，是家1星级酒店。巴塞罗那理想的下榻之处，您的旅途也将因此而与一份温暖、一份感动不期而遇。酒店位置较好，距离圣家堂打车7分钟，车程约3.8公里。	酒店	酒店
孙静，硕士，研究员，硕士生导师。	研究员	研究员
空心老大是一个汉语词语，读音是kōngxīnlǎodà，指装腔作势、无真实本领的人。	词语	词语
三国之天机军师，是一本网络连载小说，小说作者为舒笙雨，是关于秦汉三国的。	小说,网络连载小说	小说
青岛索尔集团特种车技术有限公司是青岛索尔集团下属的子公司，公司位于黄海之滨，胶州湾畔大沽河工业区，距济青高速公路仅5公里，青岛国际机场10公里，紧邻南车四方机车车辆厂和204国道，气候宜人，水、陆、空交通十分便利，是山东半岛连接内陆各省市的重要交通枢纽。	公司	公司
襄樊客来思乐娱乐酒店位于樊城区繁盛地段，紧邻永安广场、人民广场、时尚购物广场，是集住宿、娱乐、休闲为一体的新型娱乐酒店。就带你提供行李寄存、叫醒服务、送餐服务，设有停车场。房间设施齐全，有国内长途电话、24小时热水、电热水壶、电视、中央空调等。客来思乐娱乐酒店的设计哲学是追求深沉里显露尊贵，典雅中浸透豪华，并期望这种理念能够完整地体现出中西方文化精髓的融合，传达出客来思乐追求品质、典雅生活，视生活为艺术的人生态度。	酒店	酒店
《蟠桃医仙》是17k小说网连载的小说，作者是轻歌却断肠。	小说	小说
诗人怀着对故土的刻骨思念，从海外回到扬子江畔，他却愤然发现眼前的农村是如此一番风景！从而暗讽的创作了，一首反应社会现状的诗歌。	诗歌	诗歌
《月落无声雨无痕》是连载于创世中文网的异界大陆类小说，作者是越前影枫。	小说	小说
男，1963年7月生，研究生学历，教授。	教授	教授
《御释倾城乱》是连载于晋江文学城的小说，作者是小小小小宝。	小说	小说
《君临天下-千古帝王谈笑看》是一部连载在新浪读书的军事小说，作者是如此而已。	小说	小说
殷隼是《夜宴》中的人物，由黄晓明饰演，太尉之子殷隼，从年少气盛到深怀城府，这一转变值得殷隼这一人物亦正亦邪，更真实可信。为了从视觉上表现这一变化，造型师特别为黄晓明的后期造型增加了浓密的胡子设计，这让他显得更成熟，稳重，有担当，有谋略。黄晓明的英武之气，也由此发挥到淋漓尽致。	人物	人物
《月落嵯峨山》是连载于潇湘书院的小说，作者是飞彦。	小说	小说
《爱上俏丫头》是连载于红袖添香网的一本言情类小说，作者是一纸残缺映半阳。	小说	小说
深圳力合防伪技术有限公司(ShenZhenLeaguerAnti-counterfeitingTechnologyCo.,Ltd.)属于深圳清华大学研究院系统的创新型科技企业，专门从事核磁共振防伪材料、核磁共振防伪探测器和核磁共振防伪系统的研发、生产和经营，为票证防伪领域提供高端解决方案，尖端的技术和独特的商业模式，将在特定领域形成极强的竞争力。	公司	公司
武汉市华安电气有限责任公司成立于1996年，是一家民营股份制高科技企业，位于武昌区国家高新技术创业中心，交通便利，是武汉市武昌区科技局重点扶持的高新技术企业。	公司	公司
三星i777刷机，是一款电子产品，ROM大小是149MB。	电子产品	
《诱魅女医，总裁好生猛》是小说吧连载的一部综合其它小说，作者是慕文幽。	小说	小说
三地乡是四川省凉山彝族自治州会理县辖乡。民国时期属天台区辖乡，1950年属西北区辖地。1952年设三地乡，1972年改公社，1983年复置乡。	乡	
冯晓勤，女，医学博士，副教授，南方医科大学附属南方医院儿科副主任。现任广东省医学会儿科学分会常委、全国儿童血友病协作组华南区负责人、广东省地中海贫血协会理事。	南方医科大学附属南方医院儿科副主任	副教授
《回首无处寻荒芜》是晋江文学城发行的小说，作者是入骨相思7橙	小说	小说
C·迈达纳(CristianOscarMaidana)，阿根廷籍足球运动员，现效力于亚特兰特，在场位置为中场。	运动员,足球运动员	足球运动员
《男人如此多情》是易白写的网络小说连载于小说阅读网。	小说	小说
《魔王的交易》是连载的一部架空历史类小说，作者是凉凉语。	小说	小说
一部由星尘2012所作的网络小说。	小说	小说
黎水平性别男出生年月1969．11学历博士研究生学位博士职称副教授。	副教授	副教授
本书是“卖盐要不要”在起点中文网发表的一篇奇幻修真小说。被起点中文网定为潜力作品。	小说	小说
《明月之神》是残月不曾残写的网络小说连载于17k小说网。	小说	小说
辽宁省昌图市三江口镇刘塘村位于东辽河畔，距镇政府以南10公里，距古榆树镇以北15公里，左靠付家镇五丰村、右邻内蒙的向阳乡，现有六个村民组（自然屯）403户；是一个地域偏僻人多地少，资源贫乏的沿河村。	村	村
老北站上海火车北站，又称上海北火车站，简称上海北站，俗称老北站，1950年至1987年间曾称上海站，位于中国上海市闸北区天目东路宝山路口。1987年上海火车站（新客站）建成后停用，现在原址为客技站。上海铁路博物馆也是按上海北站原沪宁铁路局四层高的英式风格办公楼依原比例80%在原址上建造。新的上海火车站建成后，该站称为北站或老北站。	车站	车站,博物馆
林德塞卡普丽（Lindesaikaply），足球运动员。	足球运动员	足球运动员
TranGiaHotel位于河内，是家1星级酒店。无论您是因为出差或度假而造访河内，TranGiaHotel都会是您住宿的绝佳选择。在这里您将得到一份贴心服务、收获一份美丽心情。酒店位置较好，距离三十六行街直线距离约1公里。	酒店	酒店
《江湖妖姬》是连载于红袖添香网的一本言情小说类小说，作者是wg1995wg。	小说	小说
上海桢成酒店设备有限公司是一家专业的桌椅批发、家具租赁、桌椅租赁、沙发租赁、户外家具租赁及酒店设备销售等的大型工厂，	公司	酒店,公司
大连安全科学研究院（简称大连安科院）于2007年12月10日正式成立。大连安科院现有安全评价师52人，其中国家一级评价师35人、国家二级评价师7人、国家三级评价师10人，注册安全工程师27人。	研究院	
《曼珠沙华彼岸之吻》是由小说阅读网发行的东方玄幻类型小说，正在连载中，作者钻(7)°独特的魅力。	小说	小说
山丘陆地城门酒店位于加的斯，是家4星级酒店。是加的斯不可错过的酒店之一。在这里，您将深深体会到宾至如归的愉悦与惬意。酒店。	酒店	酒店
江苏康鹏农化有限公司是位于姜堰市桥头镇工业集中区内。是从事农药和精细有机化学品开发、生产和销售的民营科技型企业。产品90%以上出口世界各地。	公司	公司
《他母亲的伙伴（HisMother'sMate）》，澳洲作家亨利·劳森（HenryLawson）作品，全文不到300字，是一部微型小说。	小说	小说
安梯基齐拉机是一个古老而复杂的计算器。1902年，考古学家在希腊小岛安梯基齐拉（Ａｎ－ｔｉｋｙｔｈｅｒａ）附近的失事船只上发现了这个仪器，它的制造年代可以上溯到公元前100年。	仪器,计算器	
《我本堕落》是一部在云中书城连载的奇幻魔法小说，作者是影子的杀手。	小说	小说
《爱情价签》是由北京三川影视创作机构、沈阳玖目堂文化传媒有限公司、北京洋马蜂影视创作工作室联合出品、并由三川担任导演的一部现代都市题材电影。影片讲述了一对现代都市青年男女的爱情观、价值观在各种现实问题以及生活压力面前是如何转变并最终走向崩塌的故事。	电影	公司,电影
《情断潼关》是连载于起点中文网的一部异世争霸类小说，作者是西门尊粼。	小说	小说
《幻狐缘》是一部连载于幻侠小说的都市言情小说，作者是幻狐缘。	小说	小说
《无垠之幻》是连载于起点中文网的小说，作者是沐雨清秋。	小说	小说
J·尔瓦拉多(JoseRicardoAlvaradoAlberto),萨尔瓦多足球运动员现效力球队是:梅塔帕场上位置:后卫	足球运动员	足球运动员
荒古逆袭是晓枫残羽所写的一部东方玄幻小说。	小说	小说
《骊歌0》是连载于幻剑书盟的一本奇幻魔法维摩诘类小说，作者是维摩诘。	小说	小说
王田霞，女，西河大鼓演员，1930年生人。	演员,西河大鼓演员	演员
薛朝贵男中共党员贵州师范大学数学本科专业毕业，中学数学高级教师，贵阳市第十四中学副校长（分管教学工作），贵州省优秀民主管理工作者。	教师	副校长,教师
战歌峡谷位于暗夜领地灰谷，和部落兽人伐木场之间的小型战场。喜爱第一人称射击游戏(FPS)的玩家一定不会对“夺旗模式”这几个字感到陌生，战歌峡谷就是取材于这种FPS游戏中常用的对战模式的战场。战歌峡谷中的每次战斗只会有20个玩家（每方10个）参与。当玩家夺取了敌方的军旗之后，他将一路跑回自己的基地。如果没有其他玩家护送这名夺旗者，那么敌人可以很轻松地夺回自己的军旗。同样，一名玩家独力对抗整支进攻小队无异于螳臂当车。因此，玩家们必须通力合作，攻防兼备。	游戏	游戏
耀邦中学是一所以伟人名字命名的学校，于1996年新建，1999年由原中和中学和山枣潭中学合并，2000年全部竣工。	学校	学校
《草根混官场》是留不住走吧所著的一本现代小说，连载于起点中文网。	小说	小说
鲁方宇，男，1990年出生于湖北省，国家级运动健将。曾代表代表湖北多次全国锦标赛，并获得亚军。体育大会获得男子水上摩托立式水上竞速三等奖。2011年中国摩托艇联赛首站方程式级别竞速赛冠军获得者。	国家级运动健将	
《爱恋季节之悲伤蔓延》是love可爱多写的网络小说连载于小说阅读网。	小说	小说
《“试刀伤”的背后》是完结于网络的一部推理悬疑小说，作者是夏树静子。	小说	小说
黄朝封，1975年9月生，浙江玉环人，调音风系中国录音师协会会员。	调音风系中国录音师协会会员	
创立于2008年8月，前身为咪咪文学工作室，长期致力于原创文学作者挖掘与培养工作，并以推动中国文学原创事业为发展宗旨，2009年10月以此为契机策划开发了陌上香坊，并决定于2010年3月开创在线收费阅读即电子出版模式。在众多热爱陌上香坊的作者与用户关心下，陌上香坊作为国内女性网络文学小说最具潜力小说网之一，建立了完善的以创作、培养、销售为一体的电子在线出版机制，成为国内优秀文学作品在线出版平台之一，树立了业内具有影响力的行业奋进者地位。陌上香坊今后将继续以建站宗旨为发展核心，为建立国内领先的网络文化品牌而奋斗。	文学作品,小说	小说
靳国胜，男，中国人，精华学校语文教师	精华学校语文教师	
苏荣，男，汉族，1948年10月生，吉林洮南人，1974年1月参加工作，1970年1月加入中国共产党，吉林大学经济管理学院国际经济系世界经济专业毕业，在职研究生学历，经济学硕士学位。曾任十二届全国政协副主席。2017年1月23日，山东省济南市中级人民法院对第十二届全国政协原副主席苏荣受贿、滥用职权、巨额财产来源不明案一审公开宣判，对被告人苏荣以受贿罪判处无期徒刑，剥夺政治权利终身，并处没收个人全部财产；以滥用职权罪判处有期徒刑七年；以巨额财产来源不明罪判处有期徒刑七年，决定执行无期徒刑，剥夺政治权利终身，并处没收个人全部财产。苏荣当庭表示服从法院判决，不上诉。	副主席,原副主席	学校语文教师
《懵懂情愫化诗雨》是塔读文学连载的小说，作者是艾芯薇。	小说	小说
贵州省天柱县社学乡位于天柱县城的东部，伍永、天白公路穿境而过，是通往湖广的主要通道，周边与该县的八个乡镇毗邻，物华天宝、资源丰富，气候温和，土壤肥沃。	乡镇	
领土争霸是一款游戏。在三千年前，邪恶势力进入我们的世界，他们自称是人类的救世主，传播邪恶信仰统治世界，他们并没有给人们带来真正的自由，反而带来更多的痛苦和灾难。直到15年前，涅槃之王获得的权利和力量，他召集了他的支持者发起了一场伟大的战争，从此世界进入新的传奇时代！	游戏	游戏
斯威兹天堂酒店位于沙巴|已下线，是家1星级酒店。斯威兹天堂酒店通过提供优质贴心的服务和方便实用的设施，受到了客人的普遍好评。酒店。	酒店	酒店
周旭，1950年10月出生，浙江省开化县人，毕业于苏州大学艺术学院。现任浙江工业大学艺术学院院长，教授，设计艺术学科带头人，博士生导师，湖南大学兼职教授，教育部艺术设计专业教学指导分委员会委员。2003年被评为首届浙江工业大学“教学名师”。中国书法家协会会员，原湖南省书法家协会副主席。	院长	教授
《斗罗大陆之傲视群神》是在幻侠小说网上连载的一部玄幻小说，作者是小雨棚。	小说	小说
王景荣，男，1964年11月生，陕西岐山人，南开大学社会学系人力资源管理专业硕士研究生毕业。曾长期从事高校人力资源管理与研究工作，熟悉人力资源管理政策、法规、工作流程。高级人才测评师。开设人力资源测评、组织行为学、行政管理学、管理学概论等课程。长安大学高等教育研究所所长，副研究员。	副研究员	副研究员
玫瑰天使是一款女性装扮类小游戏。	游戏	游戏
昶拓自动化设备（上海）有限公司主要产品范畴：各式气压缸、精密滑台缸、夹持气缸、回转缸、导杆气缸、气压夹、空气调理组合、电磁阀、气动阀、各式辅助阀、气压控制系统、气压压床、油压压床、增压压床、气压分度盘、各式自动化系统、相关辅助配件等产品。	公司	公司
《走失在纳西文字中》是一篇抒情散文，作者是富遐。这篇文章带领我们走进美丽的丽江，走进神奇的纳西文字中。中国的文化就是靠这些力量坚韧地传承着。在中华大地上，这样有魅力的地方，能让人为之着迷为之倾倒的东西还有很多，希望你的内心也有那么一块神奇而美丽的地方，好好珍藏着这些代表文化的力量。	抒情散文	
华为ViewPoint8220是一款可视电话机，它能支持IP网络可视电话，实现传统语音交流到多媒体交流的跨越，让用户真正体会到“天涯若比邻”的亲切和温情。	可视电话机	网络可视电话,可视电话机
《武逆极》是连载于纵横中文网的一本东方玄幻类小说，作者是我不喝水。	小说	小说
杭州三华布业有限公司专业生产799型剑杆织机并开发各类纺织品，地处交通便利，环境优美的杭州市萧山区·公司多年来以“诚信经营、发展创新”为宗旨，创办至今已形成了独特的经营优势。	公司	公司
《倾歌引》是一部在晋江文学城连载的原创小说。	小说	小说
《咸鱼》是由姜锡涛执导，刁夏伟、姜锡涛等人主演的微电影。影片根据《广饶一中故事会》中的真实故事素材改编，讲述了一名高中生刘先语从堕落走向成功的故事。	电影	电影
河北在职研究生网，是石家庄世纪人和管理培训机构旗下关于在职研究生信息的权威网站。是河北省内目前最大的在职研究生教育垂直性门户网站。	网站	网站
铜山县棠张中学（TangzhangMiddleSchool）是江苏省四星级高中，学校始建于1956年，坐落于徐州市新城区南棠张镇，1978年被确立为铜山县重点中学，1994年通过市合格普通高中验收，1997年通过省重点中学验收，2004年转评为江苏省三星级普通高中，2010年晋升为江苏省四星级普通高中。据2015年7月该校官网显示，该校占地130亩，合86580㎡，建筑面积为76070㎡，绿化面积29091㎡，学校现有教学班62个，学生3081人，教职工277人。	学校	学校
上浦路210弄小区，紧靠华夏西路、济阳路，3分钟可到地铁6号线灵岩南路站，5分钟可到地铁8号线凌兆新村站，出行十分便捷。小区地处三林北部，地段优越，社区成熟，配套完善。	社区	村站,社区
《梦幻彩虹螵虫》是一款休闲小游戏，大小为1772K。	游戏	游戏
《校园游记》是连载于17k小说网的一部异术异能类小说，小说作者是香飘飘。	小说	小说
吕晶玉，女，1972年11月生，副教授，博士生导师。2007年入选辽宁省百千万人才千人层次。	教授	副教授
新西兰倍佳乳品有限公司（NewZealandBestDairyLimited）在新西兰注册，坐落在新西兰最大城市—奥克兰市。新西兰倍佳乳品有限公司是一家从事乳品研究、生产、销售和品牌建设为一体的专业乳制品企业。拥有专业的专家级研发团队，一直坚持把精心选择的各类健康产品带给中国的消费者。	公司	公司
佳得化工隶属于广州市佳得涂料胶粘有限公司，广州市佳得涂料胶粘有限公司位于广州市花都区，是一家专业生产经营涂料、树脂、胶粘剂等产品，并得到各大科研单位的大力支持。	公司	公司
《血剑凝空》作者月无迹，17k小说网连载小说。	小说	小说
汤臣倍健维生素B族，即维生素B族片，以源自德国BASF及荷兰DSM的维生素B6、B12、叶酸为主要原料经先进工艺科学加工而成特殊营养食品。富含多种维生素B。	食品	食品
《奴家爱妖孽》是金钱爱子写的网络小说连载于看书网。	小说	小说
《天宸往事》是寒烟远黛写的网络小说连载于起点中文网。	小说	小说
《忘尘心》是等雨狐狸的一部网络小说，连载于晋江文学城	小说	小说
《王的冲喜傻新娘》是一部小说，作者是箐朵朵，连载网站是17k小说网。	小说	小说
多米尼克·基乌乌，男，荷兰足球运动员，1987年09月16日出生于荷兰阿姆斯特丹。现在克卢日足球俱乐部担任后卫。	运动员	足球运动员
深圳市简易电子商务有限公司（简称：简易电商）隶属于深圳市简易互联信息技术有限公司，是一家以天猫淘宝运营托管为主体业务，全面涵盖全程全网电子商务运营、网店运营、网店装修、营销推广、客服培训等服务的高效电子商务团队；旗下服装品牌：Inlett英莱特、萤火虫，仅仅历时三年便取得不俗成绩，更成功运营包括男装品牌“斯波帝卡”、女装“音儿”、“伊芙丽”、多领域天猫知名品牌，连续2年荣获电子商务服务商最具价值奖、高效电商运营团队。	公司	公司
索尔萨是一名足球运动员，芬兰人，担任中场，现在效力于赫尔辛基足球俱乐部。	运动员,足球运动员	足球运动员
《青春路长之兵荒马乱》是纵横中文网连载的小说，作者是堇有生。	小说	小说
昆明中云商标事务所有限公司专业提供大量的有关商标申请、商标注册、版权登记、反不正当竞争、商标设计、品牌策划、中华优秀品牌咨询、著名驰名商标辅导、网站设计、域名申请、技术转让、专利咨询、商业秘密保护、诉讼等多方面的专业服务，为大客户提供个性化的系统性知识产权和整体品牌解决方案。	公司	公司
《甜宠晓晓》是连载于17k小说网的一本小说，作者是倍儿水嫩。	小说	小说
尼斯老城/鲜花市场公寓酒店位于尼斯。尼斯老城/鲜花市场公寓酒店通过提供优质贴心的服务和方便实用的设施，受到了客人的普遍好评。酒店，距离老城区步行2分钟。	酒店	酒店
加西格乐卫浴有限公司集设计、生产、销售于一体，引进得多纳米抗菌珍珠自洁釉和高温离子强化瓷釉的先进技术，采用管道施釉的方式，拥有一流的技术人才和精干的管理人员。	公司	公司
《声声慢——薛怀柔传》是连载于云中书城的架空历史小说，作者是净颜。	小说	小说
皮姆住宿加早餐酒店位于清迈，是家2星级酒店。是清迈最热门的酒店之一。也是您来到清迈商务和休闲的热门之选。酒店位置较好，距离清迈国际机场打车17分钟，车程约10.3公里。	酒店	酒店
《变质的夏季》是3G书城连载的小说，作者是梦天狐。	小说	小说
阿拉贡二世（AragornII），即伊力萨·泰尔康泰，是英国作家J.R.R.托尔金所著小说《魔戒》中的人物。他是阿拉松二世与吉尔蕾恩之子，埃西铎的第三十九代嫡孙，第十六任登丹人酋长（第三纪元2933年–3019年），刚铎及亚尔诺重联王国开国国王（即刚铎第三十四任国王，亚尔诺第二十六任国王，第三纪元3019年–第四纪元120年）。他是魔戒远征队的九名成员之一，也是魔戒圣战时期的重要人物。阿拉贡年幼时，埃尔隆德为他取名“埃斯特尔”，意为“希望”。他登基后使用“伊力萨·泰尔康泰”这一名号，意为“精灵之石·大步佬”。“大步佬”是阿拉贡年轻时，布理地区的人们对他的蔑称。在2001年至2003年由彼得·杰克逊执导的《指环王》系列电影中，阿拉贡一角由美国演员维果·莫特森饰演。	人物	演员,人物
素攀武里是一座古城，有丰富的文化和历史久远的寺庙。坐落在ThaChin河岸上，有时候当地人也叫这条河为素攀武里河·有着丰富的华人文化遗迹。	古城	寺庙
“大夫第”，一般是指文职官员的私宅。“大夫第”就是士大夫的门第，不是平民百姓的草庐。	私宅	
《长安悲歌》是编剧：黄嬿根据名著《牛虻》改编的越剧小戏。荣获2007年度“上海市戏剧小戏评选”中获戏剧、曲艺类金奖。	戏剧	小戏
《孤傲警花闯异世》是连载于起点中文网的小说，作者是溺爱偏爱。	小说	小说
北京大景盛世文化传播有限公司是一家茅台高端酒类销售及品牌运营的专业化机构，秉承“品质第一、诚信为本”的企业宗旨。	公司	公司
《冰机铸剑》是一部小说，作者是不言羽，连载网站晋江文学城。	小说	小说
藤江丽奈（日语：藤江れいな），1994年2月1日出生于千叶县，日本偶像，イトーカンパニー所属。她是为前日本女性偶像团体AKB48TeamB的成员，在48group大组阁祭中移籍至NMB48TeamM，原来是NMB48TeamM的队长。作品有《海女姑娘》等。	偶像	
奶油椰香芋球是一款甜品。用奶油做成的。	甜品	
霍特夫·斯塔尼斯拉夫，男，1981年3月7日生于俄罗斯，足球运动员	足球运动员	
富人国游戏是动网先锋自主研发的又一款模拟经营类网页游戏，游戏集合了店铺建造，商品销售，员工雇佣，商会发展和议会权力等要素，并创造性的推出了座驾升级和零件提升，让玩家在享受经营乐趣的同时可以体验竞赛游戏的内容，属于创意十足的模拟经营游戏。该游戏将于2010年11月2日正式对外发行。	游戏,网页游戏	游戏,足球运动员
男，1938年11月25日出生。清华大学硕士毕业，曾任铁科院焊接研究室主任，中国焊接学会理事。从事焊接与电控科学研究，铁道部科学研究院金化所副研究员。	研究员	副研究员
《英雄联盟之峥嵘之路》是连载于创世中文网的一部异界大陆类小说，作者是温小逆。	小说	小说
《借你一生爱》是珍珠写的网络小说连载于新浪读书。	小说	小说
上海武警医院肝病科主任医师，武警上海市总队医院传染科主任，全国武警部队卫生部传染病专业委员会副主任委员，	上海武警医院肝病科主任医师	医院肝病科主任医师
卡斯塔尼达是智利足球队的一名后卫运动员。	运动员	后卫运动员
《逃爱坏公主》是季荭写的网络小说连载于3G书城。	小说	小说
北京国通环境工程有限公司生产的“国通牌防火油烟净化器”，是非常适合我国炒菜除油烟的新一代环保产品。本产品解决了油烟在过滤、吸附时自流难、阻力大的难题；解决了机械式设备净化效率低的不足。	公司	公司
《错过的晴天》是连载于红袖添香网的一部言情类小说，小说作者是遗忘的晴天。	小说	小说
北京泽惠风科技有限公司成立于2005年，是在北京市工商行政管理局登记注册，并经过北京市消防协会培训并考核认证合格的消防检测企业，目前主要从事电气防火安全检测技术服务，建筑消防设施检测技术服务，消防器材的销售服务，烟道清洗服务。	公司	公司
2006年8月，郭敬明日前正式成立“上海柯艾文化传播有限公司（CASTOR）”，并亲自担任该文化公司的董事长，成为80后作家中的第一位“老板”。郭敬明表示，新文化公司并不算是运作两年之久的“岛”工作室的“升级版本”。而春风文艺出版社吕强明确透露，郭敬明自己筹资成立了新文化公司，原本由春风文艺投资的“岛”工作室目前隶属于该公司。	公司	公司
始创于2004年，下辖重庆泛联广告传媒有限公司、重庆泛联装饰工程有限公司、重庆泛联地产顾问有限公司、重庆泛道贸易有限公司四个专业化全资子公司。	公司	公司
榆林市宏杨广告装饰有限公司成是一家成立于2006年的集广告营销策划、设计、制作、安装为一体的综合性广告装饰服务公司。有专业的广告营销策划、设计、制作、安装团队。	公司	公司
丹尼尔·莫罗·巴林杰(DanielMoreauBarringer，1860年5月25日-1929年11月30日)是一位美国地质学家，以确认陨石撞击地球而形成撞击坑的第一人而闻名。美国亚利桑那州的巴林杰陨石坑即以他的姓氏命名作为尊敬，虽然该称呼大多使用于科学家之间。	美国地质学家	美国地质学家
达州口碑网是由达县收录网络科技有限责任公司创办，是一家汇聚企业商家信息的网站，为达州广大企业商家宣传自己提供一个可靠的、有价值、有影响力的免费网络平台。	网站	网站,公司
佛山金雅轩酒店酒店建筑面积16800多平方米，尊贵典雅，极致奢华！40平方米的豪华客房，环境幽雅的中、西餐厅、康体中心、娱乐夜总会、棋牌室、国际会议厅等配套设施一应俱全，是商务接待、旅游度假理想之首选。	酒店	酒店店
停航是一个汉语词语，拼音是tíngháng，意思是停止航行。	汉语词语	词语
武汉易天时代网络服务有限公司成立于2005年，一直致力于互联网的发展，武汉易天时代网络服务有限公司拥有网站建设、网站营销、网站推广，电子商务网站运营等成熟的互联网服务经验，提供高质量的网页设计和全方位的网络推广方案。提高企业知名度；在运营电子商务的过程中，为企业提供帮助。武汉易天时代网络服务有限公司拥有一支由资深网络从业人士组成的人才队伍，集策划、开发、设计、营销、管理等全方位专业化运作于一体，经过努力的开拓，已为几百家不同类别的企事业单位提供了优质的网站建设服务，并获得了客户的一致好评。	公司	公司
河南天韵文化传播有限公司是一家综合性文化传播机构.	公司	公司
广州桦叶光电有限公司有多名专业的技术工程师，配有防静电无尘车间，拥有强大的电子技术研发力量和丰富的光学、机械等专业技术经验，近年中成功研发多个激光产品项目。	公司	公司,工程师
上海惠生展台设计搭建公司，成立时间是2004年，占地面积是10000多平方米。	公司	公司
《斗龙战士5》是国产动画片《斗龙战士》系列的第五部系列作品，本作品剧情将延续《斗龙战士4双龙核》。	动画	
柔毛悬钩子（学名：Rubuspubifolius）是蔷薇科悬钩子属的植物，是中国的特有植物。分布在中国大陆的西藏等地，生长于海拔4,200米的地区，多生长在山路边。	植物	植物
Kiu,韩国籍足球运动员。	运动员	足球运动员
《720》是由搜狐畅游(NASDAQ:CYOU)自主研发的神秘回合网游，原金牌回合游戏团队于2009年7月20日正式组建畅游回合制项目组，该作历时三年，于2012年12月首次神秘亮相。其以宏大的仙侠世界为背景，首次实现前世今生双人设转化系统，让玩家真切感受人心与魔性、宿命与现世、爱情与道义的仙侠故事。无限的战斗策略、无限的职业体系，引人入胜，乐在其中！	游戏	游戏
邱成，男，汉族，1966年10月生，江苏睢宁人（黄作镇）。1991年10月加入中国共产党，1987年8月参加工作。徐州工程学院中文专业毕业，江苏省委党校研究生学历，硕士学位，曾任中共江苏省丰县县委书记、县人大常委会主任等职；2015年2月任江苏省徐州经济技术开发区管委会主任（副厅级）、党工委副书记。	书记	副书记
《灰姑娘的初恋》是宝贝文子写的网络小说连载于起点中文网。	小说	小说
户钰，青年葫芦丝演奏家。师从于著名民族管乐演奏家，国家一级演奏员王厚臣先生。	葫芦丝演奏家	演奏家
生物多样性是指在一定时间和一定地区所有生物（动物、植物、微生物）物种及其遗传变异和生态系统的复杂性总称。生物多样性包括遗传多样性、物种多样性和生态系统多样性。	生物	动物,生物,植物
TROJ_AGENT是一类木马程序，会窃取用户的个人信息，对用户的信息安全造成损害。	木马程序	
巴塞罗那弗兰特格拉西亚公寓酒店位于巴塞罗那。巴塞罗那弗兰特格拉西亚公寓酒店是您来巴塞罗那的最佳落脚点。这里，将一份温温软软，悄然安放于旅行的希冀之中，您定不会失望。酒店，距离圣家堂步行18分钟，或打车3分钟，车程约1.5公里。	酒店	酒店
八神穿越了是一款以经典街机游戏拳皇为背景的酷炫打斗类动作游戏，超炫的动作和打击感，即时格斗让人热血沸腾，无尽BOSS等你来挑战。	游戏	游戏
《闪客快打7中文无敌版》是一款益智小游戏，大小是1811K。	游戏,益智小游戏	游戏
弗兰克·阿苏柏迪，男，是一名足球运动员，场上的位置是中场。	运动员,足球运动员	足球运动员
陈才庚，诸暨市枫桥镇彩仙村人。曾任江西农业大学经贸学院教授、硕士研究生导师、贸经系主任、经济管理系副主任等职；现任浙江经济高等专科学校科研处处长，高教研究室主任，《浙江经济高等专科学校学报》主编，兼任全国企业领导科学研究会理事，江西省领导科学学会副会长。	教授	教授
《杀了我吧》是约翰·戴尔/JohnDahl执导，CoryCassidy等主演的电影，该片于2007年4月28日上映。故事讲述的是一位医生想将自杀转变为一种医学上的辅助行为，而不是一场悲剧。	电影	电影
一代太极宗师陈延熙，河南温县陈家沟陈氏十六世人，系“牌位大王”陈长兴之孙，“太极神手”陈耕耘之次子。生于道光二十八年，卒于民国十九年（1848-1929），享年八十一。公乃陈氏太极第八代主要传人。	传人	
兴义市城市规划展览馆，建馆于2008年10月，于2008年12月6日竣工验收。2009年元月6日正式开馆。全馆建筑面积4000余平方米，主要由城市进程图文展区、城市规划沙盘模型展区、城市仿真演示室三个部分组成。城市进程图片展区，主要展出兴义市建城以来、现状、发展及规划图片资料，是兴义市社会经济发展过程的见证。	建筑	
唐山十三农民兄弟，又称唐山十三义士，又被网友称为唐山十三侠。成员为宋志永、杨国明、杨东、王加祥、王得良、宋志先、王宝国、王宝中、曹秀军、尹福、宋久富、杨国平、王金龙十三人。均为男，河北唐山人。年龄最大62岁、最小19岁。他们是2008感动中国人物之一。	人物	人物
茶市是明朝政府在西北边地设立的与藏族诸部落进行以茶易马活动的地点。	地点	茶市
品川海滨日之轨迹酒店位于东京，是家3星级酒店。品川海滨日之轨迹酒店让您在东京这个陌生又熟悉的城市，感受到一丝清浅但又实在的温暖。您一定不能错过。酒店，距离台场打车8分钟，车程约5.1公里。	酒店	酒店
《偏偏撞见你》作者是zhmymymy，小说进度连载。	小说	小说
特里尔酒店位于科布伦茨。特里尔酒店让您在科布伦茨这个陌生又熟悉的城市，感受到一丝清浅但又实在的温暖。您一定不能错过。酒店。	酒店	酒店
《兽魂战记》是连载于起点中文网的异界大陆类小说，作者是晓文斌。	小说	小说
《他的眼神偏偏想依赖》是连城读书连载的小说，作者是鱼尔。	小说	小说
雅库布·尤加斯，男，是一名捷克籍足球运动员，场上位置是后卫。	足球运动员	足球运动员
长乐市中医院创办于1978年，现有正式职工91人，病床100张。	医院	
工艺美术大师，擅四体书法、篆刻、陶艺。现为国家文博专业副研究员、中国书法家协会会员、中国工艺美术家协会会员、中华诗词学会会员、中国楹联学会会员、世界文化艺术研究中心研究员、钦州市书法家协会现终身名誉主席。三次应邀赴新加坡、澳大利亚、美国举办个人书法篆刻坭兴陶作品展。书法、陶艺作品多次获得全国大奖。	美术家,中国书法家协会会员,工艺美术大师	美术家,副研究员,研究员,美术大师
本顿港地区机场位于美国密歇根州贝林县的本顿港口，1995-2000期间由梅萨巴航空公司提供航班服务，每天有5次航班飞往西北航空公司的基地底特律，但是该服务现已终止。最近几年本顿港机场已经停止了商业航空服务。	机场	公司
《写给欧阳的一首爱情诗》是在小说阅读网连载的杂文随笔类型小说，作者是爱吃米的阿马。	小说	小说
《逝去的梦之我不要再伪装》是连载于红袖添香网的科幻幻想小说，作者是九寒。	小说	小说
TheTrouble热超波乐队是一支由七位青年音乐家组成的民间乐队，他们用音乐讲述老百姓自己的故事。	乐队,民间乐队	民间乐队
暨佳木斯大学康复医学院、佳木斯大学附属第三医院坐落于富饶的三江沃土，美丽的松花江畔。黑龙江省小儿脑性瘫痪防治疗育中心创建于1987年，是中国第一所从事脑性瘫痪防治、康复和研究的专门机构，为省属三级甲等专科医院。在此基础上，于1999年成立佳木斯大学康复医学院，是中国康复医学会儿童康复专业委员会主任委员单位；中国残疾人康复协会小儿脑瘫康复专业委员会主任委员单位；卫生部康复医学人才培训基地。	医院	医院
《萌狐公主宸珞式》连载于小说阅读网的青春校园小说，作者是时雨Love	小说	小说
厦门岛外网网站开通于2010年7月，是兴承电子商务（岛外网运营中心）与城市中国联盟联合打造的厦门岛外综合门户网站。拥有超多超全的便民分类信息、岛外热点资讯，收录众多岛外机关、企事业单位、商家网络电话簿等，可供网民免费查询。帮助生活在快节奏城市里的现代人解决衣、食、住、行、娱乐、情感、教育、职业等等生活和工作方方面面所遇到的难题。	网站	网站
《塞洛特传说》（sarote、简称srt,塞洛特）是非著名的游戏公司云游网络（Cloud-Game）所制作的一款大型多人在线角色扮演3D网页游戏	游戏	公司
潘德润，摄影家，山东蓬莱人，中共党员，代表作《出铁》1957年获第六届世界青年联欢节摄影比赛银质奖章。	摄影家	游戏,摄影家
《元气之巅》是在云中书城上连载的一部玄幻小说，作者是沫杰儿。	小说	小说
梁杰，男，1973年9月出生，中共党员，现任深圳大学生命科学学院党委副书记，兼纪委书记。	副书记	副书记,兼纪委书记
陈鼎龙，1941年生，祖籍山东益都，满族。画家，书法家，易学家。现任陕西盛世西部书画院院长，世界华人文化传承协会顾问，易学大家。	画家,书法家,易学家	易学家,书法家,画家
绝情书，霹雳布袋戏虚拟人物。血榜女杀手，身著华丽和服，形骸放浪，喜纵情诗俳饮乐，每当其杀人时，会写下一首俳句诗签纪念。随身携带一骨灰坛，身怀血海深仇，故权倾天以凶手下落为交易，每一名凶手换取一件买卖……	人物,虚拟人物	人物
《我要一场百老汇》是一首歌曲，由林夕作词，彭羚演唱。	歌曲	歌曲
《三邪少遇上三魔女》是连载于纵横中文网的一部都市娱乐小说，作者是冷冰蓝~。	小说	小说
宁波朱金木雕是浙江省的传统手工艺。大约有1000余年历史。汉唐以来，随着木结构建筑的发展，出现了彩漆和贴金并用的装饰建筑木雕。公元759年，唐代高僧鉴真和他的弟子，在日本建造了招提寺，就采用了很多朱金木雕装饰，其中的讲经殿、舍利殿等朱金镂雕风格与现存国内的宁波阿育王寺的木雕装饰十分接近。据说是因为鉴真和尚在东渡之前曾在宁波阿育王寺居留考察了相当长时间，阿育王寺的木雕装饰风格受到鉴真的欣赏并带至日本。	建筑,工艺	
尤拉伊·克瓦塔尔，1996年7月13日出生于斯洛伐克，足球运动员。	运动员	足球运动员
坎姆图考酒店位于大叻，是家1星级酒店。大叻理想的下榻之处，您的旅途也将因此而与一份温暖、一份感动不期而遇。酒店，距离春香湖步行24分钟，或打车4分钟，车程约2.0公里。	酒店	酒店
《天使蔷薇》是小说阅读网连载的小说，作者是零夜青璃。	小说	小说
《武林欲帝》，是一部武侠言情类型的网络小说，小说签约授权首发连载于翠微居书城网站。小说共354章，现在已经完本，作者是渣子李。小说讲述了小乞丐凌啸天成为武林霸主的故事。	小说	小说
浏阳银天大酒店位于湖南省浏阳市区内，是浏阳首家通过国家星评委评定的五星级酒店。	酒店	酒店
内蒙古伊泰煤炭股份有限公司（以下简称公司），是由内蒙古伊泰集团有限公司独家发起，募集设立的B股上市公司，创立于1997年8月，并在上海证券交易所上市，公司股票简称“伊泰B股”（股票代码900948）。公司总股本146400万股，其中内蒙古伊泰集团有限公司持有企业法人股80000万股，占公司总股本的54.64%，境内上市外资股66400万股，占公司总股本的45.36%。公司是以煤炭生产经营为主业，以铁路运输、煤化工为产业延伸的大型企业。	公司	公司
建在桑给巴尔岛上，下港口相对，是坦桑尼亚原苏丹赛义德王宫。宫殿为钟楼式造型，呈白色，巍峨耸立，是桑岛最高建筑物。	建筑	建筑物
青春校园小说，小说阅读网连载。	小说	小说
《兵痞爸比妈咪归我》是坨坨梦写的网络小说连载于17k小说网。	小说	小说
保护与迷失是由中国传媒大学出版社出版的书籍，作者是宋磊，在2009年出版。	书籍	书籍
英文名：MateuszStruski，波兰足球运动员，现属霍茹夫交通队（RuchChorzow）。	运动员,足球运动员	足球运动员
《寻找美味蘑菇》是一款动作类游戏，游戏大小是1962KB。	游戏	游戏
42年后的一场杀戮是黑暗死神所著看书网连载的科幻幻想小说	小说	
特拉华大道豪宅酒店位于尼亚加拉瀑布城（美国区），是家4星级酒店。是尼亚加拉瀑布城（美国区）最热门的酒店之一。也是您来到尼亚加拉瀑布城（美国区）商务和休闲的热门之选。酒店位置较好，距离Allentown历史城区步行2分钟。	酒店	酒店,小说
《彼岸血花》是连载在红袖添香网的言情小说，作者是小三木子春。	小说	小说
埃尼奥·莫里康内，意大利电影配乐大师，欧洲电影音乐巨人，与尼诺·罗塔并誉为“欧洲电影音乐领航者”。1928年生于罗马，毕业于著名的圣切契里亚音乐学院，迄今为止已经参与制作了各国电影配乐作品400多部，是意大利最多产、最有建树的作曲家。2007年2月25日，莫里康内从克林特·伊斯特伍德手里，接过了迟到的奥斯卡终身成就奖。	电影配乐	电影配乐大师,作曲家
《嫁尸王妃》作者是诸葛少司，小说进度连载，连载网站是小说阅读网。主要讲述身墨黑的凤冠霞帔，她莫名成了新娘，还被蒙了自己独对一座无名的坟墓三叩拜堂，在墓穴里和鬼王爷的爱恨情仇。	小说	小说
《蛊女偷心记》是连载于潇湘书院的一部穿越架空小说，作者是点笑。	小说	小说
中国中铁四局集团有限公司是具有综合施工能力的大型建筑企业，是世界500强企业-中国中铁股份有限公司的骨干成员、标杆企业。	公司	公司
河南省禹州市智康调味品有限公司总部位于禹州市科技园区大道11号，占地50余亩，固定资产3600多万元，总资产6000多万元，年产值1.37亿，现有员工368人。是一家集种植、加工、销售、研发为一体的综合性集团公司。	公司	公司
《枪之舞》是在起点中文网上连载的一部小说，作者是紫叶之风。	小说	小说
龙海盛，广西北流市六靖人，现任广西大业建设工程有限公司董事长、北流市政协委员、南宁市北流商会常务副会长兼秘书长。曾获得“捐资助学模范”等荣誉称号	北流市政协委员,广西大业建设工程有限公司董事长	公司,秘书长
安同(?--429年)，北魏开国功臣。祖先是安息国的王子，汉朝时作为侍子来到中国，改姓安，后因避战乱举家迁居辽东，早年在草原经商，遇到拓跋珪之后，舍弃商旅，追随左右。北魏立国之后，历任外朝大人、广武将军、安远将军、右光禄大夫、光禄勋、征东大将军、冀青二州刺史，先后受封为北新侯、高阳公，死后追封为高阳王。	功臣,开国功臣	
诺基亚521是手机。	手机	手机
深圳市鸿迈电子有限公司是一家经营欧、美集成电路为主的元器件独立代理经销商,是集元器件销售和技术咨询、信息服务等为一体的高科技企业。	公司	公司
《唯一的例外》是由作者流光飞舞731编写的连载小说，连载网站：晋江文学城	小说	小说
《异世风流霸王》是起点中文网连载的小说，作者是诸葛雄风。	小说	小说
彭博，男，汉族，1966年4月生，研究生文化，硕士学位，1985年10月加入中国共产党，1987年7月参加工作。曾任天津市滨海新区规划和国土资源管理局党组书记、副局长。2015年7月24日，被开除党籍和公职。	副局长	副局长
古井集团是中国老八大名酒企业，是中国第一家同时发行A、B两支股票的白酒类上市公司安徽古井贡酒股份有限公司的母公司，坐落在历史名人曹操与华佗故里――安徽省亳州市。	公司	公司
大卫·拉科斯特是的法国足球运动员，英文名DavidLacoste。	运动员,足球运动员	足球运动员
北京首都开发控股（集团）有限公司（以下简称“首开集团”）于2005年12月10日正式挂牌成立。首开集团是在北京市国资委主导下由城开集团、天鸿集团合并重组形成的、以房地产开发和经营为主营业务的市属国有大型企业集团。首开集团经历了三十多年的发展历程，是中国最早成立的房地产企业之一。首开集团总资产约人民币400亿元，年开复工面积超过400万平方米；物业管理面积约2200万平方米，物业经营面积近100万平方米；年销售收入超100亿元，房地产开发综合实力在全国位居前列。	公司	公司
杨万贵，男，汉族，1963年3月生，湖北宜昌市人，1982年8月参加工作，1985年6月加入中国共产党，在职大学文化。现任中共湖北省委宣传部常务副部长。	副部长,常务副部长	副部长
煌斑岩的一种，是一种含角闪石和斜长石为主的煌斑岩。斑晶为普通角闪石，有时出现黑云母，橄榄石或辉石，基质除了斑晶矿物外，还有斜长石及少量碱性长石。	煌斑岩	
《2014机电产品报价手册》(共9分册)是机电产品价格信息数据库2014年版(配套光盘)的纸质出版物，书中收录的20多万条数据是从近40万条产品数据库中精心挑选的，涵盖了4000多家大中型企业的主要产品。其产品价格信息由各单位自报，并参照国家标准GB/T7635．1—2002《全国主要产品分类与代码》分类编辑，其内容包括：产品名称、型号规格、主要技术参数、参考价格、生产厂家、地址、邮政编码和电话等。《2014机电产品报价手册(制药及炼油化工设备分册)》是了解机电产品价格信息的重要参考工具书。其主要读者对象包括：资产评估公司、会计师事务所、招投标机构、咨询机构、价格认证中心及银行、海关、企业(事业)单位的相关人员。《2014机电产品报价手册(制药及炼油化工设备分册)》由李卫玲编著。	纸质出版物	公司,版物
《“血”雨腥风》作者是Late，是在晋江文学城连载的原创小说。	小说	小说
卡塔度假酒店位于普吉岛，是家2星级酒店。是普吉岛最热门的酒店之一。也是您来到普吉岛商务和休闲的热门之选。酒店位置较好，距离卡伦海难步行27分钟，或打车3分钟，车程约2.2公里。	酒店	酒店
帮女孩找相框是一款益智小游戏。	游戏	游戏
《无双诀》是连载于纵横中文网的小说，作者是六条毛。	小说	小说
男，汉族，生于1961年5月，潼南县柏梓镇人，中共党员，大学本科毕业，西南师范大学在职研究生，中学语文高级教师。1982年7月参加工作，1984年10月加入中国共产党。现任中共潼南县委教育工委委员、县教委副主任。	副主任	教委副主任,教师
《小黑怪的房间》是一款益智小游戏，游戏大小为137K。	游戏	游戏
奉化溪口锦堤商务宾馆是一家商务性宾馆。宾馆位于风景秀丽的溪口景区之内，与武岭门，丰镐房，玉泰盐铺等景地毗邻，九曲剡溪依窗而过，地理位置优越，交通便利。	商务性宾馆	
《我的相公好可怜》是一本关于穿越架空类型的小说，连载于小说吧。作者：遇艺	小说	小说
微电影排行榜，是中国微电影最高奖项，每年评选出当年十大微电影。自2011年创办以来，每年集优秀微电影作品于一堂，为网民们提供了一场丰富的视觉盛宴。微电影排行榜，是中国微电影最高奖项，每年评选出当年十大微电影。自2011年创办以来，每年集优秀微电影作品于一堂，为网民们提供了一场丰富的视觉盛宴。	电影	电影,电影排行榜
歌剧院是一个建筑，歌剧或者其它形式的行为艺术在其中进行表演。世界各地均有歌剧院，且具有各自不同的建筑风格。2017年12月1日，《公共服务领域英文译写规范》正式实施，规定歌剧院标准英文名为OperaHouse。	建筑	歌剧,建筑
锯齿刺鲨是角鲨科、刺鲨属的动物。	动物	动物
根据《中共大连市委办公厅、大连市人民政府办公厅关于印发&lt;旅顺口区人民政府机构改革方案&gt;的通知》（大委办发【2009】29号），设立大连市旅顺口区发展和改革局，挂大连市旅顺口区物价局牌子，正处级建制，为区政府工作部门。	政府机构	
邯郸市全脑科技教育学校（哈佛右脑训练中心）创办近十年，是邯郸市第一家潜能激发教育机构，经过不断努力现已发展四家教育基地。	学校,教育机构	学校
《岚火之夏》是连载在晋江文学城的网络小说，作者是深海魔女。	小说	小说
《隐形帝国》是连载在起点中文网的小说，作者是飞龙圣君。	小说	小说
勒索者病毒是指在网上肆虐的一个名为“勒索者（Harm.Extortioner.a）”的病毒。该病毒会删除计算机用户的文件，然后以使用盗版软件为由试图向用户勒索钱财。因此，瑞星反病毒反木马一周播报（2017.03.12－03.18）将“勒索者”列为本周关注病毒，警惕程度为★★★☆。	病毒	病毒
杭州杰唐信息技术有限公司是专门从事中间件平台、融合通讯、汽车电子嵌入式系统研发和推广的高新技术企业。	公司	公司
尼古拉斯·加西亚，男，1988年出生，是一名西班牙跆拳道运动员。	运动员,跆拳道运动员	运动员
伊利尼畔兹奥酒店位于布达佩斯。是布达佩斯最热门的酒店之一。也是您来到布达佩斯商务和休闲的热门之选。酒店，距离MagyarPenzvaltoKft.-ExchangeBureau退税点（2）打车10分钟，车程约5.6公里。	酒店	酒店
《修罗问情决》是连载于起点中文网上的一本异术异能小说，作者是对月诉相思。	小说	小说
《骗字数的》是喵叔==+的一部网络小说，连载于晋江文学城	小说	小说
是《女侦探亚玲》里的人物，跟段文一是拜把兄弟，喜欢着施玲。性别：男生日：6月6日星座：巨蟹座国籍：中国血型：B型身高：157cm年龄：12岁体重：37kg发色：深蓝瞳孔色：深蓝最喜欢的食物：汽水、汉堡最喜欢的书本：《福尔摩斯探案全集》最喜欢的人：施玲弱点：段文一、施玲班级讨论的焦点：《名侦探柯南》最喜欢的人物：毛利兰、怪盗基德/怪盗KID/怪盗1412	人物	食物,人物
合肥市第六十二中学是一所九年一贯制学校，座落在风景秀丽的大蜀山南麓、碧波荡漾的柏堰湖畔，是一所美丽的花园式学校。它是二00三年由原“安徽江南机械股份有限公司职工子弟学校”和“合肥昌河汽车有限责任公司子弟学校”整合而成的。建筑总面积8506.8平方米，校园占地面积约26000平方米，教学设备齐全。校园环境优美整洁，人文环境优雅和谐。绿化小品，清爽宜人。楼道空间合理利用，建成一个融文化、艺术、文史、科技为一体的“校园文化长廊”，为师生学习工作营造了一个舒适、优雅的环境。	学校,九年一贯制学校	公司,学校
《重生大清之永世追随》是写起点中文网连载的一本历史传奇类小说，作者是雅尔檀。	小说	小说
《不再放手》是连载于晋江文学城的小说，作者是地狱鸽。	小说	小说
《冷峻总裁囧女友》是一部小说，作者是潇灵雪，连载网站潇湘书院。	小说	小说
内蒙古派力建筑工程有限责任公司是直属于内蒙古自治区烟草专卖局（公司）全区烟草系统主管多元化经营的大型国有企业集团——内蒙古金叶实业（集团）有限责任公司的龙头企业，国家二级房屋建筑工程施工、装饰、装修工程施工总承包、起重设备安装工程施工总承包企业。	公司	公司
《行政争议法律援助》，由（中国法制出版社）在（2006年10月1日）出版的书籍。	书籍	书籍
埃德森·恩里克·达·席尔瓦是一位巴西足球运动员，于1987年7月6日生于巴西伊塔克丁加，是一位足球后卫，现效力于莱里亚联盟足球俱乐部，曾经效力于科英布拉俱乐部，贝莱嫩斯俱乐部。	运动员,足球运动员,巴西足球运动员	足球运动员
独一味万州烤鱼是天立飞香独一味餐饮管理有限公司旗下品牌。天立飞香独一味餐饮管理有限公司是一家拥有顶级管理运作团队，特色餐饮项目开发，集饮食文化传播、传统膳食开发、生产为一体的高端餐饮管理公司。2005年初北京“首”家独一味万州烤鱼总店成立，总店设立于全国美食中心--簋（GUI)街，并且带来了新的美食风暴，经过7年的经营已形成统一管理、量化生产的体系。	品牌	公司
《天使泪1》是连载于幻剑书盟的一本都市言情类小说，作者是冰封之泉。	小说	小说
普罗旺斯影城酒店位于戛纳。酒店，距离影节宫步行8分钟。	酒店	酒店
《我想死》是由易之衣在起点中文网连载的小说。	小说	小说
《阵型师》是连载于幻剑书盟的一部小说，作者是纪言。	小说	小说
魏一媚，女，教授，浙江旅游职业学院社科部（基础部）教师，1960年出生。	浙江旅游职业学院社科部（基础部）教师	教授
广州中大附属雅宝学校坐落于广州市花都区高档社区雅宝新城内，占地150亩，建筑面积7万多平方米，是一所全日制寄宿学校，设有小学部、中学部（初中、高中）、国际部。	学校	学校
茨康类（Czekanowskiales），又称为线银杏、茨康叶，是一类种子植物，生存于晚三叠世至白垩纪。	植物	植物
《名门媳》为潇湘书院网络小说不游泳的小鱼所著穿越小说，连载于潇湘书院。	小说	小说
《花语心影幻循作品》是2010年北京工艺美术出版社出版的书籍。	书籍	书籍
候候鸟是星游所著晋江文学城连载的言情类型小说	小说	
《守护甜心之命中注定》是连载的动漫同人小说，作者是蓝漠殇。	小说	小说
《慢一点，卖更快》是一本[美]凯文·戴维斯编制，由中华工商联合出版社在2012年12月1日出版的书籍。	书籍	书籍
一种木马下载器类型的病毒。影响平台Win9X/ME/NT/2000/XP/2003，危害等级一星。	病毒	病毒
北京同道中人网络科技有限公司（简称：同道科技）是北京知名互联网技术开发公司；公司由2002年成立的“同道中人”网络开发工作室发展而来，时至今日已经具备了十年的互联网开发经验；截至2012年同道科技从事互联网技术开发十年来，积累了雄厚的技术经验，形成了一套高水准的技术服务流程；十年间，该公司已经为8000多家公司企业、行业门户、电子商务等网站提供了技术支持与服务。	公司	公司
影片主要描述了：一部关于环境变化，而在艰苦环境中生活的动漫作品，本剧讲述了在地球的未来，由于太阳总是出现异常的活动，而造成大气层遭受的破坏·..…	动漫	动漫作品
人文与社会科学学院是华北电力大学下设的以人文社会科学学科为主的二级学院。学院始建于1958年，原为北京电力学院政治理论教学部，历经搬迁、调整、合并、发展，先后称为马列主义教学部、基础部、社科部，1994年更名为社科系，后又更名为法政系。2003年学校正式成立人文与社会科学学院。学院本部设在北京，在保定校区分设法政系。	学校	学校
《爱情》是王韵壹演唱的一首歌曲，收录于专辑《中国好声音哈林组四进一》，星云乐众2012-09-21发行。	歌曲	歌曲
沧县狮舞是一种河北省的传统民俗舞蹈。据历史典籍记载，沧县狮舞最早起源于汉朝，明朝时已广泛流传。沧州狮舞以同乐会形式存在，早期多在庙会和春节民间花会时活动。沧县狮舞分为文狮和武狮两类。早期称为狮戏，多为“文狮”，以兴济为代表。“文狮”以逗为主，鼓点威武豪壮，有动有静，有紧有慢，动作以动物本能动作为主，模仿猫科类戏耍动作。表演时随着鼓点的变化而变化。“武狮”以黄递铺乡北张村为代表。武狮由文狮发展而来，后来狮舞揉进武术、杂技中的动作，如叠立、走钢丝、上高凳、爬杆、高台翻滚、水中望月、巧走立绳、荷花怒放等。沧县狮舞被列为第二批国家级非物质文化遗产。	舞蹈	动物
陈钦，著名历史纪录片策划、制作人、编导，坚持"以影像修复历史，以道德修身自我"的创作理念，一直努力使其作品成为影像版的《史记》。2011年，其创作的《国军抗战全纪实》甫一面世，便获得网络总点击过亿的成绩，刷新了中国纪录片的网络播出纪录，获得了巨大的社会反馈。作品还有根据《国军抗战全纪实》改编图书《我的河山——抗日正面战场全纪实》系列三本分别为《我的河山：会战》、《我的河山：人物》、《我的河山：幕后》。《北洋大时代》、北洋2《北洋大时代：大师们的理想国》。2014年创作百集《中日百年战争全纪实》，上线播出后很快过千万点击，成为年度最受欢迎的抗战纪录片，国家军方网站将该片作为官兵士兵的爱国主义影视作品全网推广播出。2015年，创作百集纪录片《天罚-二战全纪实》，是第一部中国人制作的二战全景纪录片，也是全球第一部站在反法西斯全局凸显中国抗战贡献的作品。8集纪录片《东方诺亚方舟》首次以历史纪录片，诠释中华美德，以记录手法全景式再现犹太难民来华避难的历史。	人物	
著名青年设计师，淮阴师范学院第八届学代会代表。他专注于GUI设计、网页设计及平面设计等。钟情于充满秩序美感和形式美感的新视觉语言艺术，也醉心雕琢打磨设计的细节，关注具有实验性、前瞻性和趣味性的视觉设计创作。同时，他对无线互联网产品的设计也有一定的涉猎，曾参与数十款无线互联网产品的设计工作。	设计师	
诺丁汉盖特威酒店位于诺丁汉，是家3星级酒店。无论您是因为出差或度假而造访诺丁汉，诺丁汉盖特威酒店都会是您住宿的绝佳选择。在这里您将得到一份贴心服务、收获一份美丽心情。酒店，距离沃莱顿议事厅打车13分钟，车程约7.2公里。	酒店	酒店
鲳鱼是一种身体扁平的海鱼，因其刺少肉嫩，故很受人们喜爱，主妇们也很乐意收拾，它同样具有海洋鱼的营养特点：富含高蛋白、不饱和脂肪酸和多种微量元素。清蒸海昌鱼制作简单，营养丰富，口感颇佳。	海鱼	
老鼠嫁女又称老鼠嫁女，鼠娶亲、鼠纳妇、老鼠娶亲等，这一古老的汉族民间传说在中国很流行。作为汉族民间俗信，是汉族传统民俗文化中影响较大的题目之一，是在正月举行的祀鼠活动，其情节“版本”不一。具体日期因地而异，有的在正月初七，有的在正月二十五，不少地区是正月初十，也有的是夏历正月十四的夜半。山西平遥县初十日将面饼置墙根，名曰“贺老鼠嫁女”。	民俗	
周彤，医学博士，副教授，川北医学院附属医院大外科副主任。	副主任	副教授
扬州基尔韦伯电气有限公司成立于2003年，注册资本1118万元，公司是一家致力于电能质量产品研发、生产、销售、服务的高科技企业。公司采用欧洲标准及技术，并不断创新、生产的高质量高可靠性的产品，并将其应用于成熟的电能质量解决方案、电能质量检测监测分析系统，以及产品的系统集成。通过不断的产品更新，先进的生产方式和工程服务及支持，以适应公用事业、工业、商业、居住、电讯和原始设备市场不断变化的需求。	公司	公司
《让孩子吃点苦》是2006年中国水利水电出版社出版的书籍，作者是崔华芳。	书籍	书籍
《整垮珂萝米》是厄普代克写的网络小说连载于17k小说网。	小说	小说
《暗恋对象的吻》是连载于晋江文学城的小说，作者是并非多么真挚。	小说	小说
《暴雪大混战》是一款动作小游戏，游戏大小为652K。	游戏	游戏
林强，哈尔滨人，大陆男演员。参与编剧并导演了哈尔滨京剧院的音乐校园剧《校园-梦开始的地方》。	演员,男演员,大陆男演员	演员
打瓦是国北方部分地区流行的一种传统游戏。打瓦的动作真可谓是五花八门。包括站着打、蹲着打、跳起打、转身打、把瓦片放在脚上打、夹在两腿中间打、放在头上打等等。是农村十五岁左右的男性青少年的集体娱乐竞技与健身启智的游乐活动。它体现着进攻防守、瞄准打靶、团结互助、争优取胜、胜乐败罚的乐趣与精神。	游戏	游戏
北京金威焊材有限公司于1993年2月成立，是由中冶建筑研究总院、香港东安企业有限公司和北京市政市政一建设工程有限责任公司共同创办的中外合资企业。公司坐落于北京市昌平区沙河镇白各庄工业园区，企业现注册地为中关村科技园区昌平园。企业注册资本为5000万元人民币。	公司	公司
营口万都粤海国际会议中心（原万都大酒店）系万都实业（澳门）有限公司投资兴建的四星级酒店，位于辽东半岛环境优雅的海滨城市营口，坐落在金牛山大街西段。	公司,酒店	酒店,公司
根据《自治区党委自治区人民政府关于区直机构改革的实施意见》（桂发[2004]1号）和《自治区党委自治区人民政府关于自治区党委和自治区人民政府机构设置的通知》（桂发[2004]2号），撤销在自治区农业厅挂牌的自治区乡镇企业管理局，保留自治区农业厅。自治区农业厅是主管全区农业和农村经济发展的自治区人民政府组成部门。	政府机构	
李悟非（1919-1982）。男，学者，教授，祖籍湖北汉阳（现武汉），与著名教育家、现华中科大校长李培根原出于同族。解放前毕业于四川大学化学化工系，毕业后曾开设化工厂，一心实业救国。	教授,学者	教授
《我来替你寻心》是由若百草编写的小说。	小说	小说
以新媒体传播手段，传播品牌理念与文化，集中报道品牌信息，并以品牌指数形式向用户提供品牌动态指标的媒体称为“品牌传媒”(BrandMedia)。	品牌	
《三国志苍穹之誓》是一款基于曹操传系统改良的模拟策略类战棋游戏，集战略模拟与角色扮演于一身，属于一款老少皆宜的免费休闲类桌面游戏。	游戏	游戏
姚亦锋，副教授，硕士生导师，南京大学城市规划设计研究院风景园林规划所所长，江苏省风景园林学术委员会委员南京历史文化名城研究会理事。	南京大学城市规划设计研究院风景园林规划所所长	副教授
金与正（김여정），女，朝鲜人，金正恩胞妹，1988年出生，原朝鲜劳动党总书记、第二代最高领导人金正日四女，母亲是高英姬。金与正是金正哲、金正恩的同父母妹妹。小女儿金与正一直备受金正日宠爱。现任朝鲜劳动党中央政治局候补委员、党中央委员会第一副部长。	朝鲜劳动党中央政治局候补委员	
郴州汇源高新材料有限公司成立于2003年12月17日，注册资本1000万元，经营范围为氧化铋及云母纸板生产销售，有色金属矿产品、非金属矿产品销售。	公司	公司
《调戏小警花》是达梓写的网络小说连载于晋江文学城。	小说	小说
《网游之被迫卧底》是连载于17k小说网的一本游戏网游类小说，作者是凌晨未眠。	小说	游戏,小说
《修罗降世》是英东写的网络小说连载于17k小说网。	小说	小说
《BRAVE10》（真田十勇士）是霜月灰吏的漫画作品，于2007年10月开始在MediaFactory的杂志COMIC-FLAPPER上连载；11月21日MarineENTERTAINMENT发售广播剧CD。因杂志休刊，于2011年4月而移至《月刊ComicGENE》并更名为《BRAVE10S》（即第二部）。目前本作仍在连载中，单行本发行了8卷（至第8卷为止第一部完结），总发行量超过50万册。《BRAVE10》是一部以历史演义为题材的作品，描述战国时代末期，跟随名将真田幸村的十位奇人异士的故事。	漫画	漫画作品
山东省人口职工中等专业学校创办于1988年6月，位于济南市玉函路75号，隶属山东省计划生育委员会。建筑面积6000平方米，有教职工23人，其中专职教师14人，兼职教师6人。	学校	学校
《再躲你就死翘翘》是连载于晋江文学城的一本小说，作者是牛奶瓶。	小说	小说
《李白之牙齿掉光光》是连载于晋江文学城的小说，作者是丛★谣☆苎。	小说	小说
陈志荣是一名战士，1943年南通县金沙战斗中牺牲。	战士	
《战神狂后》是作家傲行天下创作的一本穿越架空小说，连载于红袖添香网，尚未完结。	小说	小说
《酸甜苦辣还有咸》是云中书城连载的一部小说，作者是snyrjh。	小说	小说
周思超，电视节目制片人，大型活动总导演，知名策划人。历任河北卫视大型活动导演、策划、撰稿人；河北卫视《炫动中国风》第一季策划人、总导演；《红红火火幸福年——2013河北春晚》执行总导演；河北经视大型节目制片人、《问道》栏目制片人兼总导演、周思超工作室负责人；河北卫视包装部制片人兼总导演；河北卫视青年辩论节目《青年进化论》联合制片人、河北卫视情感励志节目《中华好妈妈》制片人、河北卫视时尚健康节目《加油向前跑》制片人、河北卫视《传奇老字号》制片人、河北卫视《邻家诗话》制片人，兼任河北传媒学院新闻传播学院讲师、河北师范大学“名家讲堂”系列讲座讲师。	导演,策划,撰稿人	
车耀先（1894—1946），四川大邑人，1929年加入中国共产党，任川康特委军委委员。后在成都以经营努力餐馆为掩护从事革命活动，引导许多有志青年走上革命道路。“投身元元无限中，方晓世界可大同，怒涛洗净千年迹，江山从此属万众，愿以我血献后土，换得神州永太平。”这是中国共产党优秀党员车耀先入党后写的一首诗。正如诗中所表达的那样，他以自己的一腔热血，献给了壮丽的共产主义事业。	任川康特委军委委员	
《嗜血眷恋:禁锢的爱》是连载的言情小说，作者是馨子纯。	小说	小说
天津市和平区“耀华小学”是天津市“双高普九”达标校、天津市义务教育示范校、天津市文明学校、天津市体育传统项目学校、天津市体育后备人才学校、全国和谐教育实验基地校、全国教育科研先进实验校。	学校	学校
莱迪安·梅姆沙伊，是一名阿尔巴尼亚足球运动员。	运动员,足球运动员	足球运动员
尚基蒂是一名后卫，现在效力于爱尔福特红白足球俱乐部。	后卫	
登封市中医院位于河南省登封市中岳大街17号，建筑面积30000余平方米，是一所中医医院。	医院	医院,医医院
王正奎，男，汉族，现任姜堰市博物馆馆长。	姜堰市博物馆馆长	博物馆馆长
深圳福瑞祥五金机电有限公司是一家专业从事各类进口高档手动、电动、气动、液压、电工、测量工具及工业消耗材料等相关产品的销售及安装服务于一体的企业。为多家国际知名品牌广东省总代理。公司产品与服务涉及工业产业界、建筑业、汽车业、木工业、铁路及电力等部门。产品范围广、质量优越，具有超强的配套能力。	公司,企业	公司
《天下萌捕》是云桐墨创作的一部网络小说，连载于晋江文学城。	小说	小说
近皓月路和民和路交叉口，紧邻城市公园、庆春过江隧道出口和地铁2号线内环路站，占地面积8579平米，总建筑面积92941平米（含地下），建筑高度150米，由西班牙著名的建筑设计机构——GCA中国荷亚瑟建筑咨询事务所担纲方案设计，是未来钱江世纪城CBD内一座体现绿色生态办公理念的国际化标准高端写字楼。其富有意趣的“人”型外立面，超高五层“人”型挑空大堂，三大雅致景观空中花园，新颖的板式创新户型设计，贴心的行政酒廊和健身双会所，18台高速电梯，宽绰停车位空间配置，5A智能楼宇管理系统，完善的商务服务配套等产品特色，将充分满足新锐企业商务办公的高尚品质追求。	建筑	
《冷面老公俏娘子》是一部玄幻小说，是作者梨瑾儿的作品之一。	小说,玄幻小说	小说
香口清茶取材于杏甘茶，产自秦岭d。它是高效药材而且采取现代先进的提取工艺精制而成的植物茶汤剂。	茶	植物
涉县三珍，是指“涉县花椒、涉县柿子、涉县核桃”三种产自涉县的名优土特产品。2005年，其中的“涉县核桃”和“涉县花椒”通过国家质检总局审查，获国家原产地产品保护（地理标志产品保护）。	特产	
广东江门安宜地板有限公司是香港汇聪实业有限公司在大陆创办的企业之一，是一家专业生产天然实木地板系列产品的现代知名企业。在生产管理中，引进意大利、德国和台湾等地的先进生产流水专线。聘请资深的日本专家为技术顾问。产品严格参照ISO14001国际环境管理模式。此外，安宜公司将引导消费者以天然木地板构成现代家居的组成之一，并接受其成为一种享受新文化作为公司的目标。从而，安宜公司在吸收现代化专业人才，加盟公司进行经营管理的同时，以选择优质天然木材为产品依托，营造消费者心中名牌粉剂包装机为经营理念。使安宜公司的发展得以稳步，并使今天的安宜迅速在中国建立超过120个经营网点，产品远销香港、日本、美国、欧洲等国家和地区。	公司	公司
《网游之虚幻国度》是连载于晋江文学城的一部小说，作者是西厢月。	小说	小说
点春秋是四川雅颂餐饮管理有限公司旗下的主打品牌。雅颂公司自成立以来，致力于新式快餐产业的研发和商业运作，构筑强大的综合设施，建立从产品开发到售后管理全过程，以及完善的责任管理系统。本着“德本才末、注重沟通”的原则，雅颂公司现已建成产品研发、客户服务、品牌运作和后勤保障为核心支柱的4大管理中心，并已形成集厨房加工、物流配送、品牌塑造等诸方面的无缝对接和专家团队，为顾客提供美味的食品和健康快乐，为员工提供人性化的管理和高速成长的工作平台，并与合作伙伴一起分享市场开发的成果。	公司,食品,品牌	公司
《千金老婆休想逃》是瀞香写的网络小说连载于17k小说网。	小说	小说
《寄生边缘》是潇湘书院的一部都市生活小说，作者是海草公主。	小说	小说
《彼岸少年》是风起扶疏花飘香的一部言情类小说，连载于晋江文学城	小说	小说
陈佳铭出生地点是中国江西，职业是作家。	作家	作家
济南金强激光数控设备有限公司成立于2004年，位于美丽的泉城济南，是中国最具影响力的专业的激光设备研发、制造、销售商之一。	公司	公司
《羽在下》是连载于起点中文网的网络小说，作者是元素无双。	小说	小说
韩朝宗（686－750），中国唐朝政治人物，韩朝宗最早担任左拾遗。唐睿宗想要下令推广乞寒胡戏，韩朝宗跟皇帝劝阻。皇帝觉得他的意见很好，就封他为中上考。韩朝宗任官时喜欢提拔后进，曾经推荐崔宗之、严武与蒋沇等人于朝廷，受到当时其他人的尊敬。	人物	人物
《五小姐的幸福爱恋》是在连城读书连载的小说，作者是指甲月月。	小说	小说
北京千方科技集团有限公司创立于2000年，是植根于中关村的自主创业企业，致力于成为中国领先的智能交通产品和解决方案提供商。	公司	公司
石奋（公元前220年—公元前124年），字天威，号万石君，河内郡温县（今河南温县西南）人，西汉大臣。不通文学，恭谨无比。初为小吏，随侍汉高祖。爱其恭敬，召其姊为美人，以奋为中涓。汉文帝时，官至太子太傅，太中大夫。汉景帝即位，列为九卿，身为二千石，四子皆官至二千石，号为万石君，后以上大夫禄养老归家。元朔五年，卒。长子石建，郎中令。少子石庆，官至丞相。	西汉大臣	
中国酒业协会（英文：CHINAALCOHOLICDRINKSASSOCIATION，缩写CADA）是由应用生物工程技术和有关技术的酿酒企业及为其服务的相关单位自愿结成的行业性的全国性的非营利性的社会组织。其主要职能是遵守中华人民共和国的宪法，接受政府委托，开展行业管理工作；反映行业情况和意见，维护会员的合法权益，全心全意为行业服务；适应社会主义市场经济发展需要，推动酿酒行业生产、管理、装备、流通、科技水平的逐步提高；协调与其他行业之间的合作与交流；不断扩大国际间的交往；为促进行业的健康发展和国民经济发展做出应有的贡献。	协会	协会
ZP宫殿酒店位于第比利斯，是家4星级酒店。是第比利斯最热门的酒店之一。也是您来到第比利斯商务和休闲的热门之选。酒店。	酒店	酒店
丽水经济开发区第二小学位于丽水市经济开发区富岭街道，学校周边环境优越、风景优美。	学校	学校
《邪恶美人与冰山王子》是连载于云中书城的一部小说，作者是安雨妍。	小说	小说
《血通天下》是连载于起点中文网的小说，作者是浮空青竹。	小说	小说
谁家少年貌倾城是一部小说，作者懒人幽幽	小说	小说
E·甸达，男，生于1989年4月3日，足球运动员，司职中场。	足球运动员	足球运动员
喷气式飞机生成器是大小为24MB的动作游戏。	游戏	游戏
根据《中共贵州省委办公厅贵州省人民政府办公厅关于印发〈六盘水市人民政府机构改革方案〉的通知》（黔委厅字〔2009〕73号）和《中共六盘水市委六盘水市人民政府关于市人民政府机构改革的实施意见》（市发〔2010〕4号）精神，设立六盘水市经济和信息化委员会，为市人民政府工作部门。	政府机构	
《一列封闭的列车》是英茨威格写的网络小说连载于17k小说网。	小说	小说
灵山县妇幼保健院（灵山县妇女儿童医院）创建于1963年，是全县的妇幼保健业务指导中心、妇女儿童疾病诊治中心和危重孕产妇第二转诊中心，是复旦大学CMB项目培训基地。	医院	医院
李英勤，男，1958年10月生于广西扶绥县，壮族，中共党员。1984年毕业于黔南师范专科学校中文系汉语言文学专业；1991年毕业于贵州师范大学汉语言文学专业；1999年毕业于贵州省委党校经济学专业研究生班。曾任县史志办助理编辑，高校组织人事处负责人、科研处暨学报编辑部负责人（执行副主编）。现任黔南民族师范学院管理科学系经济学教授，兼任黔南州“十二五”规划专家委员会委员。	教授	教授,学校
莫斯科大都会酒店1903年由实业家马蒙托夫创建，是莫斯科的代表建筑。宾馆由英国设计师沃尔科特设计建造，整个建筑建造得非常精美，特别是宾馆正面由布尔贝利创作的马赛克画《睡美人》，具有极高的欣赏价值。在十月革命时期，这里曾是召开革命议会的场所，列宁经常在这里发表演说，现在也经常会有国内外的政界要人住在这里。	酒店	酒店,演说
波卡拉地标酒店位于博卡拉，是家4星级酒店。波卡拉地标酒店是您来博卡拉的最佳落脚点。这里，将一份温温软软，悄然安放于旅行的希冀之中，您定不会失望。酒店位置较好，距离国际登山博物馆打车11分钟，车程约4.9公里。	酒店	酒店
彩云之星—金峰酒店是以接待大众消费、普通商务客人和自助旅游者为主要客源的经济型商务酒店，是昆明市“旅店业卫生A级放心单位”。	酒店	酒店
人名比较著名的人物有1.中央电视台中文国际频道记者系列报道《走进内蒙古》主创记者之一，深入鄂尔多斯、巴彦淖尔、阿拉善盟、乌海进行报道。2.体操运动员在全国艺术体操比赛中多次获得冠亚军称号3.副教授主要研究方向是汽车节能与排放控制、汽车结构与设计理论。4.中山大学教授/博士导师研究方向环境化学污染物致癌机制研究人体细胞转化模型的建立和应用5.古琴演奏家，马来西亚青山艺术学院总监6.厦门大学教授等。	人物,记者	教授,运动员,人物
随着海南国际旅游岛相关政策的正式出台，海南的发展已然上升至国家级战略，迎来了前所未有的时代契机，世界目光聚焦于此，中国旅游地产也因此呈现出蓬勃发展的新局面。在此背景之下，中国房产信息集团、易居中国、新浪、携程旅行网、如家酒店集团五家海外上市集团联合发起并成立中国旅游地产服务（集团）有限公司，总部设于海南。中国旅游地产服务（集团）有限公司以五家集团公司为依托，整合各优势资源，在旅游地产领域前瞻性地规划并建立“售前、售中、售后”营销服务体系，及线上线下互动的推广模式，针对海南区域特点，全力服务海南国际旅游岛。	公司	酒店,公司
《借我一缕忧·殇》是因诺的一部网络小说，连载于红袖添香网	小说	小说
撒拉泰国日报大厦酒店位于曼谷，是家1星级酒店。撒拉泰国日报大厦酒店通过提供优质贴心的服务和方便实用的设施，受到了客人的普遍好评。酒店位置较好，距离暹罗广场打车9分钟，车程约4.9公里。	酒店	酒店
在中国推出的特殊车型，也是第一辆体现中国元素的卡丁车。采用了憨态可掬的熊猫形象，俏皮的黑眼圈、肥硕的体型、慵懒的神情，处处都显露出国宝无可匹敌的的可爱气质。配备了G3引擎的熊猫车更独有100%熊猫超级加速功能，让所有的对手望尘莫及。赶快加入熊猫一族，拥有百分百中国力量吧！	卡丁车	
北京燕之庐网络技术有限公司创建于2008年9月，经过4年风雨间，已经成为了国内一流的网站设计公司，致力于系统化解决各大企业品牌在互联网上的统一性传播，以及企业品牌在互动产品上的应用。作为国内网站设计公司中的领军企业，在网站设计服务中从网站高端咨询策划、界面设计、交互设计，到网站程序开发、网站视觉识别系统（WebVI），无一不创造性地提供满足企业的不同需求的一站式解决方案。协助企业通过在线品牌的塑造，建立长久的企业价值。	公司	公司
大卫·埃尔姆（DavidElm），1983年1月10日出生于瑞典布罗库拉（Broakulla,Sweden），瑞典职业足球运动员，司职前锋，效力于卡尔马足球俱乐部。	运动员,足球运动员	足球运动员
张万冬，男，1935年出生于山东寿光。毕业于中国书画函大潍坊分校，自幼爱好书画篆刻，涉猎广泛，擅长花鸟。师承王雪涛、于希宁等画师。其作品先后在韩国、巴西、日本等地隆重展出。有的作品入编《潍坊书画家》、《世界华人书画家大辞典》、《中国当代诗书画印精英大典》、，寿光书画集粹》、《世界傅世名画法书鉴赏》等书，特授予"跨世纪中外书画艺术名人"荣誉称号	名人	
欧姆贝属（Oldhamina）是腕足动物门有铰纲长身贝目的一属。壳体长卵形。腹壳高凸，背壳凹，铰合线直而短。腹壳内侧隔板顶端尖锐，向前方强烈倾斜。晚二叠世，亚洲及欧洲。中国常见于南方上二叠统。	动物	动物
《漠上花》是爱已沧桑写的网络小说连载于起点中文网。	小说	小说
《失落之城》是一款由南京圣骥网络科技有限公司倾力研发的一款MMOARPG页游大作。主要围绕着唤醒被沉封的文明、立足于大陆之巅为游戏目的而引导玩家在游戏中提升自我，探索发现。独具匠心的天赋系统、坐骑系统、宠物系统，大大的丰富了玩家的战斗体验，在玩家轻松游戏之余，也可让玩家感受到纵横异界，挥斥方遒的淋漓之感。	游戏,一款MMOARPG页游大作	游戏,公司
《花开花落之惜恋知多少》是连载于小说阅读网的一部热血青春类小说，作者是浅未语。	小说	小说
《哇哈帅哥不用钱》是17k小说网连载的一部作品，作者是派小訫。	小说	小说
姜波，男，中共党员，江苏师范大学化学化工学院副教授，硕士生导师，苏州大学博士研究生。	副教授	副教授
上海现代国际旅行社系上海红领巾服饰有限公司全额投资的独立法人企业。法人代表任国辅，经营范围国内旅游、入境旅游业务。上海现代国际旅行社有限公司企业注册资金695万，已建有闸北、虹口、徐汇、奉贤、金山等6家直面市民的营业部和一个由17支精英营销队伍组成的营销中心，业务部门还设立了电子商务部，实现了网上销售和在线支付，也更好地为自由人旅游做好了单订景点门票、酒店、机票等的预定服务。	公司	公司
海南迎宾馆地处国兴大道，毗邻新省政府大楼，西临新海航大厦。豪华邮轮似的楼体外形，尽显“尊贵享受、气宇不凡”之特性，且特设贵宾接待服务设施，是集商务、会议为一体的接待型酒店。从酒店乘车至海口美兰国际机场仅需15分钟，至大型购物超市仅5分钟，地理位置四通八达，是商务活动、会议举办的理想之地。海口迎宾馆客房整体色调柔和，人性化布局设计，超大的落地窗、玻璃观景阳台使客房空间通透明亮。	酒店	酒店
董佑勤（1929~2013），男，浙江省台州市人。中国共产党党员。原中共浙江省委办公厅主任。中共浙江省委第八届候补委员，浙江省政协第四届委员，第六届、第七届常委、第七届学习委员会副主任。	中共浙江省委办公厅主任	
熊猫卫士钛金版v6.00.02简体中文版PandaTitaniumAntivirus+Antispyware2006中文名称是熊猫卫士钛金版2006防病毒软件	软件	
《爱新觉罗胤禵新转》是轩辕小糊涂神编写的一部连载小说。中题材为历史军事。	小说	软件,小说
《纸张飞扬着思念》是一部在小说阅读网连载的言情小说，作者是城里叹雾。	小说	小说
得宝牌，是中央私营企业局商标注册处注册第30号的品牌。	品牌	品牌
《随手而作》是连载于晋江文学城的一本小说，作者是想家的孩子。	小说	小说
《我的爱丽丝女友》是一部小说，作者是瑧至善。	小说	小说
新桥自然村隶属云南省保山市昌宁县柯街镇联合行政村，属坝区，是村委会、联合村完小、村卫生所所在地。据相关资料显示，该村国土面积3.49平方公里，海拔1000米，年平均气温19.5℃，年降水量1060毫米。	自然村	
济阳东方液压机械有限公司，是专业生产系列液压升降台的专业企业，是液压升降平台专业定点生产厂家之一	公司	公司
陈立品（1911年-1990年7月18日）。原名陈慧芳，艺名陈烈品。香港甘草演员。在1980年代是当时全电视台年纪最大的艺员。孙儿黄宗赐亦是同期无线艺员，多饰演叛逆青年死靓仔之类的角色。	演员	演员
多辊矫直机是一种尺寸适合安置在矫直机的上辊组与下辊组之间的金属测量板。	金属测量板	
唐山市丰南区第一实验小学始建于1905年（清光绪三十一年），原名国民学堂。后改称初等小学堂。一九二七年改称河头小学。一九二九年，学校奉县令改称完全小学。历史进入了崭新的二十一世纪，丰南区第一实验小学也进入了一个崭新的历史发展阶段。有了九十多年的发展积淀之后，第一实验小学开始步入内涵发展的良性轨道。首先是抢占信息技术的制高点，继续大力开展电化教育研究，先后组织教师参加河北省电化教育教学比赛，获得好成绩。	学校	学校
巴地亚·阿柯蒂布安诺庄园是现存最古老的葡萄酒庄之一，其历史可追溯到一千多年前。它是生产商，也是修道院，是个每年都会有数百名游客来参观的历史纪念碑。更重要的，它是司徒奇·普林涅提家族的都老家，这个家族在过去的一个半世纪里掌管着这庄园。罗伯托和他的父亲皮耶罗管理葡萄园和酿酒厂，罗伯特的姐姐埃玛努拉则负责推销及公共关系。	酒	酒庄
《强制契约：霸上魅惑前妻》是连载的网络小说作品，作者是秋紫陌。	小说,小说作品	小说作品
《大学之末》是一部连载于晋江文学城的小说，作者是关小宅。	小说	小说
《三国之戏诸侯》的作者是雨落尘缘，在小说阅读网连载。	小说	小说
《蠕虫先生》是一款有趣的射击游戏，游戏中三个蠕虫并排运行在草原的小路上，它们要在规定的时间内达到吉普车才能回家。路上有各种的障碍，需要消灭它们。	游戏,射击游戏	游戏
新丰中学位于饶北山区中心点的新丰镇联山南麓，是新丰职业技术学校内的附属初中。	学校	学校
《凌驾天元》是在纵横中文网连载的一部玄幻小说作品，作者是紫晶之颠。	小说,小说作品	小说作品
ThinkPadX201t3093AC9平板电脑，双核心四线程，自动超频最高至2.93GHz,DMI总线2.5GT/s。	电脑	
《火影之玄凰》是连载于起点中文网的一本小说，作者是唯约。	小说	小说
沈居辉是演艺界的多面手，在演艺圈，只要他能涉足的，基本上都有涉足，具体的有舞台剧，话剧，主持，演员，歌唱等。毕业于上海戏剧学院，是正经的演艺学校出身，具有良好的演艺功底。	演员	演员,学校
《重生后的混乱生活》是会跳水的红烧鱼所写的都市类网络小说，连载于起点中文网。作品简介：若上天再给了你次机会，让你带着现在的知识和阅历穿越回到你小时候重新开始，你会干些什么……	小说	小说
射击游戏（Shootergame），简称为STG。游戏类型的一种，也是动作游戏的一种。射击游戏带有很明显的动作游戏特点，也没有纯然的射击游戏，因为射击必须要经过一种动作方式来呈现它的“射击”。所以不论是用枪械、飞机，只要是进行“射击动作”的游戏都可以称之为射击游戏。为了和一般动作游戏区分，只有强调利用“射击”途径才能完成目标的游戏才会被成为射击游戏。	游戏	游戏
《我用三年换三天》，作者支离破碎傻，是红袖添香网连载小说。	小说	小说
7海别墅酒店位于龙目岛，是家3星级酒店。是龙目岛最热门的酒店之一。也是您来到龙目岛商务和休闲的热门之选。酒店位置较好。	酒店	酒店
影视后期制作就是对拍摄完的影片或者软件制作的动画，做后期的处理，使其形成完整的影片，包括加特效，加文字，并且为影片制作声音等。后期软件具体可以分为平面软件、合成软件、非线性编辑软件、三维软件。	制作	动画,软件
是最追求创意和原创的设计师，致力于酒店室内设计，商业空间（品牌专卖店）设计，办公空间设计(OFFICE）,会所、售楼样板房、高档住宅室内设计，建筑外立面设计等。并与东部集团地产、鹏城建筑集团、鹏基地产、深业地产等优秀品牌建立了良好、稳定、长久的合作关系。作品多次入选国内室内设计杂志书籍的刊登出版。	设计师	酒店,书籍
《一笑百媚之失色江山》是红袖添香网连载的小说，作者是zixunlanying。	小说	小说
公司简介厦门芝麻街电子商务有限公司成立于2010年3月，是福建省焦点传媒集团公司（简称‘焦点集团’）旗下的一家致力于电子商务发展的集团公司，总部设立于美丽的鹭岛厦门。公司自成立以来备受政府、市政府领导的重视与大力支持，多次亲临现场指导工作。目前公司在软件开发与销售、互联网服务与电子商务、房地产开发与营销、国际贸易与金融服务等行业里取得了骄人的成绩。公司目前办公场所占地面积1万多平方米，集团公司有员工1600余人。在福州、泉州、漳州、龙岩等地都有分公司。主要经营范围涉及电子商务、软件服务、食品饮料，金融服务（快钱福建总代理），网络搜索（百度福建代理）。	公司	公司
《瞰凡录》是起点中文网连载的小说，作者是林俊，目前已完结。	小说	小说
云南傣族在中秋之夜，盛行“拜月”风俗。傣族传说，月亮是天皇第三个儿子岩尖变的。岩尖是个英勇刚强的青年，他曾率领傣族人民打败过敌人，赢得了傣族乡亲的爱戴。后来，他不幸死后，变成了月亮，升向天空，继续发出柔和的月光，在黑暗中给傣族人民带来光明。	风俗	
《杀戳血世》是小说阅读网连载的小说，作者是虚空嗜幻。	小说	小说
飞船大逃亡是4399小游戏网上的射击小游戏	游戏	游戏
脊索动物门-&gt;脊椎动物亚门-&gt;-&gt;鸟纲-&gt;今鸟亚纲-&gt;-&gt;今颚总目-&gt;雀形目-&gt;-&gt;-&gt;绣眼鸟科-&gt;-&gt;-&gt;绣眼鸟属-&gt;	动物	游戏,动物
闫玉厚，男，生于1958年7月，职称：实验师。	实验师	
甘肃省宁县第二中学始建于1956年6月，系独立高级中学、庆阳市首批示范性普通高中之一。学校地处宁县城中心，校园占地91亩（其中学校南山绿化区域21亩），教学楼、科技楼、实验楼、宿舍楼和餐厅楼等建筑面积30000平方米，理化生实验室、语音室、微机室、电教室、阅览室等教学设施齐全，校图书馆纸质图书54000余册，电子图书10万余册，有300米标准跑道的操场。在近60年的办学历史中，形成了“以人为本，求真务实，和谐发展，追求卓越”的办学理念；“以人为本，内涵发展、以德治校、科研强校、特色兴校、质量立校、抢抓机遇、加快发展”的总体办学思路；“团结、进取、求实、创新”的校风；“勤于治学，乐于奉献，学为人师，行为世范”的教风；“尊师，守纪，勤学，多思”的学风；“自尊，自律，自强，自立”的校训；“求真务实，开拓创新，团结协作，民主办学”的领导作风；“德育为首，教学为主，全面育人，提高质量”的办学指导思想；“建规模特色学校，育合格特长人才，创陇原一流名校，办人民满意教育”的办学目标。	学校	学校
《手机拳击赛》是一款动作小游戏，游戏大小为3480282K。	游戏	游戏
北京盈创经纬文化传播有限公司总部位于北京，经营范围为国外经贸从业人员培训与考务工作。	公司	公司
宜阳县技工学校是经河南省劳动和社会保障厅，洛阳市劳动和社会保障局批准的，宜阳县人民政府主办，县人事劳动和社会保障局承办的宜阳县唯一一所中等专业技工学校。学校位于河南省洛阳市红旗东路宜洛矿口向南600米，处于宜阳县工业区中心地带，占地55亩，交通便利，环境优雅。	学校	学校
《现代医学》前身为《铁道医学》，原由铁道部主管、南京铁道医学院和中国铁道学会医学委员会共同主办出版。创刊于1964年，1966年停刊，1976年复刊。2000年4月，南京铁道医学院与东南大学合并，经国家教育部、科技部和新闻出版署批准，《铁道医学》从2002年第2期起更名为《现代医学》，新刊号为CN32-1659/R，主管单位改为教育部，主办单位改为东南大学。	医学	
王培秋，男，汉族，中共党员，硕士，农业推广研究员，1960年3月出生，1981年8月参加工作，1992年1月—1994年12月任安化县农业局粮油站站长，1995年1月—1999年任农业局副局长、党委委员分管业务，1999年5月因晋升职称辞去副局长职务，曾任安化县农技推广中心主任，安化县人民政府蔬菜办公室主任，2002年10月评为湖南省首批注册科技咨询师，1996年-2006年任安化县科学技术进步奖评审委员会委员，益阳市农学会理事，安化县农学会理事长，安化县农业系列初级职称评审委员会主任，湖南省作物学会会员。	研究员	油站站长,研究员
1993年在北京国际艺苑举办个人画展，引起京城艺术界轰动，作品收录和发表在《世界美术作品精选》、《世界当代名画家》等几十种刊物中。	画家	
《彼岸花开到荼蘼》是魔女恩恩写的网络小说连载于小说阅读网。	小说	小说
太阳的罪恶，电影名称，讲述主人公阿尔贝托·莫拉维亚的故事，他是意大利作家，1907年11月28日生于罗马。	电影	电影,作家
MA是YY全频道管理员的英文简称。	管理员	
张升，广东阳春市人，文学学士、历史学硕士，现为北京师范大学历史学院教授、硕士生导师、博士生导师，历史文献学会会员。主要研究方向为历史文献学、明清史。研究的课题主要集中在：《永乐大典》、四库学、图书传播、明清之际士大夫。	教授,北京师范大学历史学院教授	教授
PPQ战术海军型（英语：PPQTACTICALNAVY）是一款衍生型，它具有一个已经被修改为靠近水和水中的环境操作的发射机构。	衍生型	发射机构
中国证期操盘手协会（ChinaSecurities&amp;FuturesTraderAssociation），成立于2011年11月14日，经由香港政府批准成立的法人团体。协会是两岸三地证券期货等行业操盘手的专业组织，旨在为操盘手提供专门的展示平台，加强操盘手间的交流与合作，以期相互促进，共同提高。	协会	协会
《魔界online》是一款由金酷软件开发的2D网络游戏。该游戏有荣誉系统、官位系统、家具系统以及高等级职业转职系统等。	游戏,2D网络游戏	游戏
上海俊雄物流有限公司的前身为上海俊雄危险品运输有限公司，成立于1998年，经全体员工十四年来不懈的努力和优化体制，在管理和优势上不断壮大，于2011年02月14日正式更名为上海俊雄物流有限公司。	公司	公司
蒸鸡蛋糕是以鸡蛋为主要原料做成的一种食品，色泽分明、口感甜香软滑，味美适口、老少咸宜。	食品	食品
《倾城更倾心·你是我的》是连载于红袖添香网的一本言情类小说，作者是婧岚。	小说	小说
媚生传是由风里安创作的言情小说，连载在红袖添香网。	小说	小说
《成长的圣》是连载于起点中文网的小说，作者是抽着烟看着小说。	小说	小说
古巴老将索尼娅-比塞特在过去十年来都是世界排名前十位的标枪运动员，至今仍在国际赛场上极具威胁。2001年8月7日，在加拿大埃德蒙顿举行的第8届世界田径锦标赛中，古巴女子链球名将索尼娅-比塞特勇夺一枚铜牌。	运动员	标枪运动员
《iTré!》是美国流行朋克乐队GreenDay新专辑三部曲《iUno!iDos!iTré!》的最终版。专辑《Uno!》于2012年9月率先发行，《Dos!》于11月13日正式发行，最终版《Tré!》定于12月11日发行·	专辑	
《替夫从军》是连载于云中书城的小说，作者是catandrat。	小说	小说
克劳德·德雷是法国艺术品收藏界响当当的人物，在全球各地拥有多家酒店和豪宅。然而日前，这位素以性格固执著称的亿万大亨竟然离奇死在了其位于巴黎市郊的豪华别墅中。不过，案发现场并无陌生人闯入和搏斗的痕迹，室内的贵重物品竟然一件也不少！据警方初步分析，凶手很可能是名职业杀手，并且使用了消音器。至于其作案动机，目前仍在调查之中。	人物	酒店,人物
何东，中国著名娱乐记者兼非常道主持人。	主持人	
弗罗兰·斯查肯(FlorianSchacken),德国足球运动员。	运动员,足球运动员	足球运动员
王西峰男，1964年9月生，本科学历，研究员。	研究员	研究员
《彼岸之时：诅咒几世轮回》是一部连载的小说，作者是昏鸦。	小说	小说
《守护甜心之缘起》是连载于晋江文学城的一部动漫同人小说，作者是吐着泡泡的老虎。	小说	小说
女，1963年生，工学博士。浙江工贸职业技术学院轻工系教授。兼任《皮革科学与工程》、《西部皮革》杂志编委，张铨基金委员会委员，浙江省皮革标准化技术委员会委员。	教授,浙江工贸职业技术学院轻工系教授	教授
《对，是我错》是竹心写的网络小说连载于潇湘书院。	小说	小说
《绝世天罚》是由灰色爵爷编写的东方玄幻类小说，于看书网连载。	小说	小说
村庄由来相传明永乐后建村，有财主在高阜上盖了一座楼，遂将村叫作楼子埠。	村庄	村庄
儒豹公司的创始人、现任儒豹公司的CEO韩松博士曾在机器人研究领域专研了十几年，对“Robot（机器人）”这个单词很有感情，而手机搜索引擎就像一个随时随地为用户寻找最贴心信息的小机器人，所以就把网站的名称定为“Roboo”（译名“儒豹”）韩总解释道，儒，代表人文、知识、技术含量；豹，代表速度、敏锐、目标准确。“而且豹这种动物的习性我也很喜欢，豹有蛰伏期，这很像我们新兴企业，需要前期的准备与积累，最好才能在竞争中取胜。”	网站	公司
瀛富国际建材家居采购中心是由广州瀛富国际总公司距广州天河瀛富五金建材商贸广场之后，倾力打造集高端建材家居和装饰材料、五金机电、建筑材料为一体，一站式批发兼零售的采购中心。	公司	公司
本公司是一家集科研、开发、生产于一体的化妆品专业生产企业。致力于：护肤类、发用类、香水类、美容修饰类等化妆品的生产。专业承接OEM\ODM国内外日化产品的加工订单。	公司	化妆品专业生产企业,公司
《美味童话》是一部连载于小说吧的仙侠异侠小说，作者是冰巧月。	小说	小说
反刍亚目的名称来自于这些动物在休息时将半消化的食浆重新咀嚼，然后将这样再次磨碎的食物咽下，进行真正的消化。包括鼷鹿类、鹿类和洞角类。它们从始新世晚期开始出现，到中新世开始繁盛成为分布最广、种类和数量最多的有蹄动物。所有现生的和已绝灭的偶蹄类可分成三个亚目，即猪形亚目(suiformes)、胼足亚目(tylopoda)和反刍亚目(ruminantia)。	动物	动物,食物
中南路站是武汉地铁2号线与武汉轨道交通4号线的换乘车站，位于武汉市武昌区。	车站	车站
休闲类模拟经营小游戏	游戏	
《午夜派对花花公子》是一款手机端的益智类小游戏。该游戏于2006年上市。	游戏	游戏
R·可利亚，男，生于1975年3月21日，阿根廷足球运动员，司职中场。	足球运动员	足球运动员
闵鸿昌中国著名男高音歌唱家，国家一级演员，享受国务院政府津贴的专家。曾任原中央乐团和中国轻音乐团、中国歌舞团，中国东方歌舞团独唱演员。早年师从歌唱家黄源尹。后师从于中国老一辈著名男高音歌唱家、声乐教育家魏鸣泉教授多年，深得魏鸣泉教授厚爱。	歌唱家	歌唱家,专家,演员,教授,唱演员
《神魔兄弟》是阿色写的网络小说连载于起点中文网。	小说	小说
《疯狂总动员之翻牌对对碰》是一款益智类小游戏，游戏大小为1264K。	游戏	游戏
弹击甲虫，游戏大小17.70M，英文名称FlickBeetle，是一款家庭游戏。	游戏	游戏
《我的世界之旅》是一部在飞卢小说网连载的动漫同人类小说，作者是吾为妖孽。	小说	小说
检测英才网是一家专为从事建筑工程、材料、房屋结构、道路桥梁、金属结构、水利水电、室内环境等相关检测企业提供招聘、求职、培训和相关顾问的网上人力资源综合解决方案供应商。产品包括：网络招聘、资质升级、猎头服务、薪资调查等服务。检测英才网是中国最权威的检测人才招聘网站。	网站	网站
广州威乐普斯建材有限公司与2002年成立至今专业从事室内装饰建材销售，公司架构完善，有销售部、采购部、技术开发部等等部门一共25位优秀员工，分别在北京，上海成立了办事处。	公司	公司
狄奥尼索斯裴森酒店位于塞尔丘克。塞尔丘克理想的下榻之处，您的旅途也将因此而与一份温暖、一份感动不期而遇。酒店。	酒店	酒店
红烧土豆是用土豆制作的一道家常菜，土豆软烂酥香。土豆具有很高的营养价值和药用价值，其营养素丰富，含有蛋白质、矿物质(磷、钙等)、维生素等多种成分，营养结构也较合理，有“地下苹果”之称。	家常菜	
《玉埋深宫》是由三少龙一编写，在云中书城上连载的小说。	小说	小说
《风逐千山过》是一部小说，作者是光速逆火，连载网站连城读书。	小说	小说
北京市石景山区向阳小学是北京市石景山区教委直属的全民所有制事业单位。位于京西衙门口村始建于1910年，是一所百年老校。学校占地14400平方米，建筑面积4061平方米，学校设一至六年级，20个教学班，学生700名左右。	学校	学校
钱氏教育成立于1999年5月,是经教育主管部门批准成立的以中小学全科、早期教育、艺体培训出国留学培训及留学服务等多项目的综合性教育服务机构。年培训达2万人次，全职、兼职教师近200名，教学总面积已达10000平方米，是德阳地区规模最大、影响力最广、口碑最好的品牌教育机构之一。学校自成立之始，始终坚持“实力保证质量，质量打造声誉”的办学宗旨，以“诚信、坚持、务实、协作、创新”为教育核心，以“正规、专业、诚信”为办学特色，创建了8大精品校区和4大教育子品牌，深受学生和家长的喜爱。	学校,教育机构	学校
宋王，中国古代王爵位称号。周慎靓王三年（前318年），戴偃（宋王偃）（宋康王）自立为王，宋国国君开始称王，亦是中国历史上第一位宋王。后历代有以“宋”为地名封王。中国历史上一共有25位宋王，其中戴氏1人，刘氏2人，元氏2人，宇文氏1人，杨氏1人，王氏2人，宋氏1人，辅氏1人，李氏5人，石氏1人，赵氏2人，耶律氏2人，完颜氏3人，朱氏1人。著名的宋王有刘裕，李宪，完颜宗望等。	历史,称号	
